type octile
height 130
width 130
map
......@..@...@@@.@..@....@..@....@...............@..........@@........@..@...@@@.@..@....@..@....@........@..@...@@@.@..@....@..@.
..@.....@@..@.................@.........@...@...@.@.@.@...........@.....@@..@.................@.......@.....@@..@.................
...@.@........@..........@@..@.....@@......@...@...@...............@.@........@..........@@..@.....@...@.@........@..........@@..@
...............@@....@.@...@............@...@.....@.....@@@....@...............@@....@.@...@.......................@@....@.@...@..
..@....@..@................@.......@@@......@........@.......@@@..@....@..@................@.......@..@....@..@................@..
.....@@..@.@....@.............@.@...@......@.....@@.@................@@..@.@....@.............@.@........@@..@.@....@.............
..@......@....@..@.@.@...@@...@....@...........@@@..@..@..@....@..@......@....@..@.@.@...@@...@....@..@......@....@..@.@.@...@@...
...@@@.@.....@.@....@...@@...@...............@.@....@....@.....@...@@@.@.....@.@....@...@@...@.........@@@.@.....@.@....@...@@...@
@@.@...@.....@.....@.....@.............@@@..@...@......@........@@.@...@.....@.....@.....@..........@@.@...@.....@.....@.....@....
..........@...@@........@...@...@....@.........@.........@................@...@@........@...@...@.............@...@@........@...@.
....@.......@..@..............@.........................@...@@......@.......@..@..............@.........@.......@..@..............
........@.@@..@............@@.@@@...@....@..@..@.@@.@..@@.@..@.@........@.@@..@............@@.@@@...........@.@@..@............@@.
.@..@@@...........@..............@...@..........@@@@......@..@...@..@@@...........@..............@...@..@@@...........@...........
.@....@...@.....@@.....@....@...@....@.........@..@@@.....@@...@.@....@...@.....@@.....@....@...@....@....@...@.....@@.....@....@.
.......@...........@...@...........@@..................................@...........@...@...........@.......@...........@...@......
.......@@....@....@..@..@..@@.....@.@.......@......@..@@@@....@........@@....@....@..@..@..@@.....@........@@....@....@..@..@..@@.
.......@.........@.@..@.@........@............@........@...@...........@.........@.@..@.@........@.........@.........@.@..@.@.....
...@.............@.............@....@.@......@...@.............@...@.............@.............@.......@.............@............
..............@@..@@......@..@..................@....@..@....@................@@..@@......@..@....................@@..@@......@..@
@.@....@..@..@.@..@.@@.....................@@...............@@..@.@....@..@..@.@..@.@@..............@.@....@..@..@.@..@.@@........
.@.......@..........@.@@........@..@@.....@@@......@.....@.......@.......@..........@.@@........@..@.@.......@..........@.@@......
...@..@...@..@...@..@.....@..............@.@.@....@..@....@........@..@...@..@...@..@.....@............@..@...@..@...@..@.....@...
........@@............@.....@........@@.................................@@............@.....@...............@@............@.....@.
..@....@..............@...................@.....@.....@@..........@....@..............@...............@....@..............@.......
....@.@.......@..@.@...........@.......................@.....@@.....@.@.......@..@.@...........@........@.@.......@..@.@..........
.@.....@@...........@@.@.@.@.@.@@...@..@.@.......@@.........@....@.....@@...........@@.@.@.@.@.@@....@.....@@...........@@.@.@.@.@
...@...@.@@....@.........@@...@.....@...................@..@@......@...@.@@....@.........@@...@........@...@.@@....@.........@@...
@.@@.@....@.......@.............@..@....@...............@.......@.@@.@....@.......@.............@..@@.@@.@....@.......@...........
.....@................@@....@.@.......@@........@..@....@.....@......@................@@....@.@..........@................@@....@.
..@@......@.@.@.....@...@@..@.@.....@......................@...@..@@......@.@.@.....@...@@..@.@.......@@......@.@.@.....@...@@..@.
@@....@...@................@.............@.......@...@...@..@..@@@....@...@................@........@@....@...@................@..
...................@.@.........@@.....@.....@.....@....@.....@.....................@.@.........@@......................@.@........
@.@@....@.@..@.@..@..@..........@......@.@..@..@...@..@.........@.@@....@.@..@.@..@..@..........@...@.@@....@.@..@.@..@..@........
@.....@................@.@.@.....@@.@...@..@.....@..@...........@.....@................@.@.@.....@@.@.....@................@.@.@..
.............@..@@...@..@...@@@@.....@..@.......@...@....@@....@.............@..@@...@..@...@@@@.................@..@@...@..@...@@
@.@.......@...@..@...........@..@.........@....@..@..@.@........@.@.......@...@..@...........@..@...@.@.......@...@..@...........@
@@@@..@..@...............@......@..........@...@...@.@..@..@@..@@@@@..@..@...............@......@...@@@@..@..@...............@....
@@....@...............@.....@..@..@@......@@...............@@...@@....@...............@.....@..@..@@@@....@...............@.....@.
@......@.@@.@..@@.@@@...@.......@......@.........@....@....@....@......@.@@.@..@@.@@@...@.......@...@......@.@@.@..@@.@@@...@.....
.........@@@........@@...........@.....@....@.@.@....@.@...@.............@@@........@@...........@...........@@@........@@........
................@.@..@@.....@...@.@.@..@........@...@..........@................@.@..@@.....@...@.@.................@.@..@@.....@.
...@..@..@.........@@.....@....@.........@..@...@@@...........@@...@..@..@.........@@.....@....@.......@..@..@.........@@.....@...
..@.....@...@............@..@......@....@......@.....@@@....@.@@..@.....@...@............@..@......@..@.....@...@............@..@.
........@.....@@....@.....@.@.....@.....@.@..@..............@..@........@.....@@....@.....@.@.....@@........@.....@@....@.....@.@.
...@.........@....@................@.@@...........@.....@...@......@.........@....@................@...@.........@....@...........
..@@@......@@..........@@.................@..@...@@..@.......@....@@@......@@..........@@.............@@@......@@..........@@.....
@..@........@..@.@...@....@.......@......@...@...........@......@..@........@..@.@...@....@.......@.@..@........@..@.@...@....@...
.....@.@.......@.@@......@.....@..@...@......@@@.....@.......@@......@.@.......@.@@......@.....@..@......@.@.......@.@@......@....
..@....@...@@....@.@.@@@........@...@.@.......@.....@.....@.......@....@...@@....@.@.@@@........@.....@....@...@@....@.@.@@@......
.............@@.....@@...@.......@@.@....@.@.....@@.@@.......@...............@@.....@@...@.......@@..............@@.....@@...@....
..@.......@......@......@...........@@.@..........@.@@..@..@......@.......@......@......@.............@.......@......@......@.....
.....@....@@..@...@...@.......@......@....@..@@....@...@.@...........@....@@..@...@...@.......@..........@....@@..@...@...@.......
..@.......@..@.............@.@@......@@.@...@.........@........@..@.......@..@.............@.@@.......@.......@..@.............@.@
@@...@....@.@..@.@..@..@..@.@.@...@@@...@.@......@..@....@....@.@@...@....@.@..@.@..@..@..@.@.@...@@@@...@....@.@..@.@..@..@..@.@.
.....@.......@.......@..@..........@@@............@.....@.@.@........@.......@.......@..@..........@.....@.......@.......@..@.....
...@....@......@.@...@..@..@.....@@@@@...@.....@..@.@..@...@.......@....@......@.@...@..@..@.....@@@...@....@......@.@...@..@..@..
.....@.....@...@...@@...@...@@..@...@..............@...@...@.@@......@.....@...@...@@...@...@@..@........@.....@...@...@@...@...@@
.......@....@.@@...@@.@@........@....@.@.@@@..@....@....@@..@..........@....@.@@...@@.@@........@..........@....@.@@...@@.@@......
......@....@@....@@.@.@....@.@.@..@.@......@...@.....@@...............@....@@....@@.@.@....@.@.@..@.......@....@@....@@.@.@....@.@
.......@@..@...........@....@....@......@..@..@...@.@.@@@......@.......@@..@...........@....@....@.........@@..@...........@....@.
.@.........@....@..@.....@.........@@..@.....@.....@...@..@......@.........@....@..@.....@.........@.@.........@....@..@.....@....
@.@...@...@...@...@@@@@.@..@@....................@.@@...@....@..@.@...@...@...@...@@@@@.@..@@.......@.@...@...@...@...@@@@@.@..@@.
@..........@@.....@..@...@........@@.@.@....@..@@...............@..........@@.....@..@...@........@@@..........@@.....@..@...@....
@.@....@...............@........@..@.@@@.............@@.@.......@.@....@...............@........@..@@.@....@...............@......
......@..@...@@@.@..@....@..@....@...............@..........@@........@..@...@@@.@..@....@..@....@........@..@...@@@.@..@....@..@.
..@.....@@..@.................@.........@...@...@.@.@.@...........@.....@@..@.................@.......@.....@@..@.................
...@.@........@..........@@..@.....@@......@...@...@...............@.@........@..........@@..@.....@...@.@........@..........@@..@
...............@@....@.@...@............@...@.....@.....@@@....@...............@@....@.@...@.......................@@....@.@...@..
..@....@..@................@.......@@@......@........@.......@@@..@....@..@................@.......@..@....@..@................@..
.....@@..@.@....@.............@.@...@......@.....@@.@................@@..@.@....@.............@.@........@@..@.@....@.............
..@......@....@..@.@.@...@@...@....@...........@@@..@..@..@....@..@......@....@..@.@.@...@@...@....@..@......@....@..@.@.@...@@...
...@@@.@.....@.@....@...@@...@...............@.@....@....@.....@...@@@.@.....@.@....@...@@...@.........@@@.@.....@.@....@...@@...@
@@.@...@.....@.....@.....@.............@@@..@...@......@........@@.@...@.....@.....@.....@..........@@.@...@.....@.....@.....@....
..........@...@@........@...@...@....@.........@.........@................@...@@........@...@...@.............@...@@........@...@.
....@.......@..@..............@.........................@...@@......@.......@..@..............@.........@.......@..@..............
........@.@@..@............@@.@@@...@....@..@..@.@@.@..@@.@..@.@........@.@@..@............@@.@@@...........@.@@..@............@@.
.@..@@@...........@..............@...@..........@@@@......@..@...@..@@@...........@..............@...@..@@@...........@...........
.@....@...@.....@@.....@....@...@....@.........@..@@@.....@@...@.@....@...@.....@@.....@....@...@....@....@...@.....@@.....@....@.
.......@...........@...@...........@@..................................@...........@...@...........@.......@...........@...@......
.......@@....@....@..@..@..@@.....@.@.......@......@..@@@@....@........@@....@....@..@..@..@@.....@........@@....@....@..@..@..@@.
.......@.........@.@..@.@........@............@........@...@...........@.........@.@..@.@........@.........@.........@.@..@.@.....
...@.............@.............@....@.@......@...@.............@...@.............@.............@.......@.............@............
..............@@..@@......@..@..................@....@..@....@................@@..@@......@..@....................@@..@@......@..@
@.@....@..@..@.@..@.@@.....................@@...............@@..@.@....@..@..@.@..@.@@..............@.@....@..@..@.@..@.@@........
.@.......@..........@.@@........@..@@.....@@@......@.....@.......@.......@..........@.@@........@..@.@.......@..........@.@@......
...@..@...@..@...@..@.....@..............@.@.@....@..@....@........@..@...@..@...@..@.....@............@..@...@..@...@..@.....@...
........@@............@.....@........@@.................................@@............@.....@...............@@............@.....@.
..@....@..............@...................@.....@.....@@..........@....@..............@...............@....@..............@.......
....@.@.......@..@.@...........@.......................@.....@@.....@.@.......@..@.@...........@........@.@.......@..@.@..........
.@.....@@...........@@.@.@.@.@.@@...@..@.@.......@@.........@....@.....@@...........@@.@.@.@.@.@@....@.....@@...........@@.@.@.@.@
...@...@.@@....@.........@@...@.....@...................@..@@......@...@.@@....@.........@@...@........@...@.@@....@.........@@...
@.@@.@....@.......@.............@..@....@...............@.......@.@@.@....@.......@.............@..@@.@@.@....@.......@...........
.....@................@@....@.@.......@@........@..@....@.....@......@................@@....@.@..........@................@@....@.
..@@......@.@.@.....@...@@..@.@.....@......................@...@..@@......@.@.@.....@...@@..@.@.......@@......@.@.@.....@...@@..@.
@@....@...@................@.............@.......@...@...@..@..@@@....@...@................@........@@....@...@................@..
...................@.@.........@@.....@.....@.....@....@.....@.....................@.@.........@@......................@.@........
@.@@....@.@..@.@..@..@..........@......@.@..@..@...@..@.........@.@@....@.@..@.@..@..@..........@...@.@@....@.@..@.@..@..@........
@.....@................@.@.@.....@@.@...@..@.....@..@...........@.....@................@.@.@.....@@.@.....@................@.@.@..
.............@..@@...@..@...@@@@.....@..@.......@...@....@@....@.............@..@@...@..@...@@@@.................@..@@...@..@...@@
@.@.......@...@..@...........@............@....@..@..@.@........@.@.......@...@..@...........@......@.@.......@...@..@...........@
......@..@...@@@.@..@....@..@....@...............@..........@@........@..@...@@@.@..@....@..@....@........@..@...@@@.@..@....@..@.
..@.....@@..@.................@.........@...@...@.@.@.@...........@.....@@..@.................@.......@.....@@..@.................
...@.@........@..........@@..@.....@@......@...@...@...............@.@........@..........@@..@.....@...@.@........@..........@@..@
...............@@....@.@...@............@...@.....@.....@@@....@...............@@....@.@...@.......................@@....@.@...@..
..@....@..@................@.......@@@......@........@.......@@@..@....@..@................@.......@..@....@..@................@..
.....@@..@.@....@.............@.@...@......@.....@@.@................@@..@.@....@.............@.@........@@..@.@....@.............
..@......@....@..@.@.@...@@...@....@...........@@@..@..@..@....@..@......@....@..@.@.@...@@...@....@..@......@....@..@.@.@...@@...
...@@@.@.....@.@....@...@@...@...............@.@....@....@.....@...@@@.@.....@.@....@...@@...@.........@@@.@.....@.@....@...@@...@
@@.@...@.....@.....@.....@.............@@@..@...@......@........@@.@...@.....@.....@.....@..........@@.@...@.....@.....@.....@....
..........@...@@........@...@...@....@.........@.........@................@...@@........@...@...@.............@...@@........@...@.
....@.......@..@..............@.........................@...@@......@.......@..@..............@.........@.......@..@..............
........@.@@..@............@@.@@@...@....@..@..@.@@.@..@@.@..@.@........@.@@..@............@@.@@@...........@.@@..@............@@.
.@..@@@...........@..............@...@..........@@@@......@..@...@..@@@...........@..............@...@..@@@...........@...........
.@....@...@.....@@.....@....@...@....@.........@..@@@.....@@...@.@....@...@.....@@.....@....@...@....@....@...@.....@@.....@....@.
.......@...........@...@...........@@..................................@...........@...@...........@.......@...........@...@......
.......@@....@....@..@..@..@@.....@.@.......@......@..@@@@....@........@@....@....@..@..@..@@.....@........@@....@....@..@..@..@@.
.......@.........@.@..@.@........@............@........@...@...........@.........@.@..@.@........@.........@.........@.@..@.@.....
...@.............@.............@....@.@......@...@.............@...@.............@.............@.......@.............@............
..............@@..@@......@..@..................@....@..@....@................@@..@@......@..@....................@@..@@......@..@
@.@....@..@..@.@..@.@@.....................@@...............@@..@.@....@..@..@.@..@.@@..............@.@....@..@..@.@..@.@@........
.@.......@..........@.@@........@..@@.....@@@......@.....@.......@.......@..........@.@@........@..@.@.......@..........@.@@......
...@..@...@..@...@..@.....@..............@.@.@....@..@....@........@..@...@..@...@..@.....@............@..@...@..@...@..@.....@...
........@@............@.....@........@@.................................@@............@.....@...............@@............@.....@.
..@....@..............@...................@.....@.....@@..........@....@..............@...............@....@..............@.......
....@.@.......@..@.@...........@.......................@.....@@.....@.@.......@..@.@...........@........@.@.......@..@.@..........
.@.....@@...........@@.@.@.@.@.@@...@..@.@.......@@.........@....@.....@@...........@@.@.@.@.@.@@....@.....@@...........@@.@.@.@.@
...@...@.@@....@.........@@...@.....@...................@..@@......@...@.@@....@.........@@...@........@...@.@@....@.........@@...
@.@@.@....@.......@.............@..@....@...............@.......@.@@.@....@.......@.............@..@@.@@.@....@.......@...........
.....@................@@....@.@.......@@........@..@....@.....@......@................@@....@.@..........@................@@....@.
..@@......@.@.@.....@...@@..@.@.....@......................@...@..@@......@.@.@.....@...@@..@.@.......@@......@.@.@.....@...@@..@.
