type octile
height 70
width 70
map
......@..@...@@@.@..@....@..@....@...............@..........@@........
..@.....@@..@.................@.........@...@...@.@.@.@...........@...
...@.@........@..........@@..@.....@@......@...@...@...............@.@
...............@@....@.@...@............@...@.....@.....@@@....@......
..@....@..@................@.......@@@......@........@.......@@@..@...
.....@@..@.@....@.............@.@...@......@.....@@.@................@
..@......@....@..@.@.@...@@...@....@...........@@@..@..@..@....@..@...
...@@@.@.....@.@....@...@@...@...............@.@....@....@.....@...@@@
@@.@...@.....@.....@.....@.............@@@..@...@......@........@@.@..
..........@...@@........@...@...@....@.........@.........@............
....@.......@..@..............@.........................@...@@......@.
........@.@@..@............@@.@@@...@....@..@..@.@@.@..@@.@..@.@......
.@..@@@...........@..............@...@..........@@@@......@..@...@..@@
.@....@...@.....@@.....@....@...@....@.........@..@@@.....@@...@.@....
.......@...........@...@...........@@.................................
.......@@....@....@..@..@..@@.....@.@.......@......@..@@@@....@.......
.......@.........@.@..@.@........@............@........@...@..........
...@.............@.............@....@.@......@...@.............@...@..
..............@@..@@......@..@..................@....@..@....@........
@.@....@..@..@.@..@.@@.....................@@...............@@..@.@...
.@.......@..........@.@@........@..@@.....@@@......@.....@.......@....
...@..@...@..@...@..@.....@..............@.@.@....@..@....@........@..
........@@............@.....@........@@...............................
..@....@..............@...................@.....@.....@@..........@...
....@.@.......@..@.@...........@.......................@.....@@.....@.
.@.....@@...........@@.@.@.@.@.@@...@..@.@.......@@.........@....@....
...@...@.@@....@.........@@...@.....@...................@..@@......@..
@.@@.@....@.......@.............@..@....@...............@.......@.@@.@
.....@................@@....@.@.......@@........@..@....@.....@......@
..@@......@.@.@.....@...@@..@.@.....@......................@...@..@@..
@@....@...@................@.............@.......@...@...@..@..@@@....
...................@.@.........@@.....@.....@.....@....@.....@........
@.@@....@.@..@.@..@..@..........@......@.@..@..@...@..@.........@.@@..
@.....@................@.@.@.....@@.@...@..@.....@..@...........@.....
.............@..@@...@..@...@@@@.....@..@.......@...@....@@....@......
@.@.......@...@..@...........@..@.........@....@..@..@.@........@.@...
@@@@..@..@...............@......@..........@...@...@.@..@..@@..@@@@@..
@@....@...............@.....@..@..@@......@@...............@@...@@....
@......@.@@.@..@@.@@@...@.......@......@.........@....@....@....@.....
.........@@@........@@...........@.....@....@.@.@....@.@...@..........
................@.@..@@.....@...@.@.@..@........@...@..........@......
...@..@..@.........@@.....@....@.........@..@...@@@...........@@...@..
..@.....@...@............@..@......@....@......@.....@@@....@.@@..@...
........@.....@@....@.....@.@.....@.....@.@..@..............@..@......
...@.........@....@................@.@@...........@.....@...@......@..
..@@@......@@..........@@.................@..@...@@..@.......@....@@@.
@..@........@..@.@...@....@.......@......@...@...........@......@..@..
.....@.@.......@.@@......@.....@..@...@......@@@.....@.......@@......@
..@....@...@@....@.@.@@@........@...@.@.......@.....@.....@.......@...
.............@@.....@@...@.......@@.@....@.@.....@@.@@.......@........
..@.......@......@......@...........@@.@..........@.@@..@..@......@...
.....@....@@..@...@...@.......@......@....@..@@....@...@.@...........@
..@.......@..@.............@.@@......@@.@...@.........@........@..@...
@@...@....@.@..@.@..@..@..@.@.@...@@@...@.@......@..@....@....@.@@...@
.....@.......@.......@..@..........@@@............@.....@.@.@........@
...@....@......@.@...@..@..@.....@@@@@...@.....@..@.@..@...@.......@..
.....@.....@...@...@@...@...@@..@...@..............@...@...@.@@......@
.......@....@.@@...@@.@@........@....@.@.@@@..@....@....@@..@.........
......@....@@....@@.@.@....@.@.@..@.@......@...@.....@@...............
.......@@..@...........@....@....@......@..@..@...@.@.@@@......@......
.@.........@....@..@.....@.........@@..@.....@.....@...@..@......@....
@.@...@...@...@...@@@@@.@..@@....................@.@@...@....@..@.@...
@..........@@.....@..@...@........@@.@.@....@..@@...............@.....
@.@....@...............@........@..@.@@@.............@@.@.......@.@...
......@..@...@@@.@..@....@..@....@...............@..........@@........
..@.....@@..@.................@.........@...@...@.@.@.@...........@...
...@.@........@..........@@..@.....@@......@...@...@...............@.@
...............@@....@.@...@............@...@.....@.....@@@....@......
..@....@..@................@.......@@@......@........@.......@@@..@...
.....@@..@@@....@.............@.@...@......@.....@@.@................@
