type octile
height 160
width 160
map
......@..@...@@@.@..@....@..@....@...............@..........@@........@..@...@@@.@..@....@..@....@........@..@...@@@.@..@....@..@....@...............@..........
..@.....@@..@.................@.........@...@...@.@.@.@...........@.....@@..@.................@.......@.....@@..@.................@.........@...@...@.@.@.@.....
...@.@........@..........@@..@.....@@......@...@...@...............@.@........@..........@@..@.....@...@.@........@..........@@..@.....@@......@...@...@........
...............@@....@.@...@............@...@.....@.....@@@....@...............@@....@.@...@.......................@@....@.@...@............@...@.....@.....@@@.
..@....@..@................@.......@@@......@........@.......@@@..@....@..@................@.......@..@....@..@................@.......@@@......@........@......
.....@@..@.@....@.............@.@...@......@.....@@.@................@@..@.@....@.............@.@........@@..@.@....@.............@.@...@......@.....@@.@.......
..@......@....@..@.@.@...@@...@....@...........@@@..@..@..@....@..@......@....@..@.@.@...@@...@....@..@......@....@..@.@.@...@@...@....@...........@@@..@..@..@.
...@@@.@.....@.@....@...@@...@...............@.@....@....@.....@...@@@.@.....@.@....@...@@...@.........@@@.@.....@.@....@...@@...@...............@.@....@....@..
@@.@...@.....@.....@.....@.............@@@..@...@......@........@@.@...@.....@.....@.....@..........@@.@...@.....@.....@.....@.............@@@..@...@......@....
..........@...@@........@...@...@....@.........@.........@................@...@@........@...@...@.............@...@@........@...@...@....@.........@.........@..
....@.......@..@..............@.........................@...@@......@.......@..@..............@.........@.......@..@..............@.........................@...
........@.@@..@............@@.@@@...@....@..@..@.@@.@..@@.@..@.@........@.@@..@............@@.@@@...........@.@@..@............@@.@@@...@....@..@..@.@@.@..@@.@.
.@..@@@...........@..............@...@..........@@@@......@..@...@..@@@...........@..............@...@..@@@...........@..............@...@..........@@@@......@.
.@....@...@.....@@.....@....@...@....@.........@..@@@.....@@...@.@....@...@.....@@.....@....@...@....@....@...@.....@@.....@....@...@....@.........@..@@@.....@@
.......@...........@...@...........@@..................................@...........@...@...........@.......@...........@...@...........@@.......................
.......@@....@....@..@..@..@@.....@.@.......@......@..@@@@....@........@@....@....@..@..@..@@.....@........@@....@....@..@..@..@@.....@.@.......@......@..@@@@..
.......@.........@.@..@.@........@............@........@...@...........@.........@.@..@.@........@.........@.........@.@..@.@........@............@........@...@
...@.............@.............@....@.@......@...@.............@...@.............@.............@.......@.............@.............@....@.@......@...@..........
..............@@..@@......@..@..................@....@..@....@................@@..@@......@..@....................@@..@@......@..@..................@....@..@...
@.@....@..@..@.@..@.@@.....................@@...............@@..@.@....@..@..@.@..@.@@..............@.@....@..@..@.@..@.@@.....................@@...............
.@.......@..........@.@@........@..@@.....@@@......@.....@.......@.......@..........@.@@........@..@.@.......@..........@.@@........@..@@.....@@@......@.....@..
...@..@...@..@...@..@.....@..............@.@.@....@..@....@........@..@...@..@...@..@.....@............@..@...@..@...@..@.....@..............@.@.@....@..@....@.
........@@............@.....@........@@.................................@@............@.....@...............@@............@.....@........@@.....................
..@....@..............@...................@.....@.....@@..........@....@..............@...............@....@..............@...................@.....@.....@@....
....@.@.......@..@.@...........@.......................@.....@@.....@.@.......@..@.@...........@........@.@.......@..@.@...........@.......................@....
.@.....@@...........@@.@.@.@.@.@@...@..@.@.......@@.........@....@.....@@...........@@.@.@.@.@.@@....@.....@@...........@@.@.@.@.@.@@...@..@.@.......@@.........
...@...@.@@....@.........@@...@.....@...................@..@@......@...@.@@....@.........@@...@........@...@.@@....@.........@@...@.....@...................@..@
@.@@.@....@.......@.............@..@....@...............@.......@.@@.@....@.......@.............@..@@.@@.@....@.......@.............@..@....@...............@...
.....@................@@....@.@.......@@........@..@....@.....@......@................@@....@.@..........@................@@....@.@.......@@........@..@....@...
..@@......@.@.@.....@...@@..@.@.....@......................@...@..@@......@.@.@.....@...@@..@.@.......@@......@.@.@.....@...@@..@.@.....@......................@
@@....@...@................@.............@.......@...@...@..@..@@@....@...@................@........@@....@...@................@.............@.......@...@...@..
...................@.@.........@@.....@.....@.....@....@.....@.....................@.@.........@@......................@.@.........@@.....@.....@.....@....@....
@.@@....@.@..@.@..@..@..........@......@.@..@..@...@..@.........@.@@....@.@..@.@..@..@..........@...@.@@....@.@..@.@..@..@..........@......@.@..@..@...@..@.....
@.....@................@.@.@.....@@.@...@..@.....@..@...........@.....@................@.@.@.....@@.@.....@................@.@.@.....@@.@...@..@.....@..@.......
.............@..@@...@..@...@@@@.....@..@.......@...@....@@....@.............@..@@...@..@...@@@@.................@..@@...@..@...@@@@.....@..@.......@...@....@@.
@.@.......@...@..@...........@..@.........@....@..@..@.@........@.@.......@...@..@...........@..@...@.@.......@...@..@...........@..@.........@....@..@..@.@....
@@@@..@..@...............@......@..........@...@...@.@..@..@@..@@@@@..@..@...............@......@...@@@@..@..@...............@......@..........@...@...@.@..@..@
@@....@...............@.....@..@..@@......@@...............@@...@@....@...............@.....@..@..@@@@....@...............@.....@..@..@@......@@...............@
@......@.@@.@..@@.@@@...@.......@......@.........@....@....@....@......@.@@.@..@@.@@@...@.......@...@......@.@@.@..@@.@@@...@.......@......@.........@....@....@
.........@@@........@@...........@.....@....@.@.@....@.@...@.............@@@........@@...........@...........@@@........@@...........@.....@....@.@.@....@.@...@
................@.@..@@.....@...@.@.@..@........@...@..........@................@.@..@@.....@...@.@.................@.@..@@.....@...@.@.@..@........@...@.......
...@..@..@.........@@.....@....@.........@..@...@@@...........@@...@..@..@.........@@.....@....@.......@..@..@.........@@.....@....@.........@..@...@@@.........
..@.....@...@............@..@......@....@......@.....@@@....@.@@..@.....@...@............@..@......@..@.....@...@............@..@......@....@......@.....@@@....
........@.....@@....@.....@.@.....@.....@.@..@..............@..@........@.....@@....@.....@.@.....@@........@.....@@....@.....@.@.....@.....@.@..@..............
...@.........@....@................@.@@...........@.....@...@......@.........@....@................@...@.........@....@................@.@@...........@.....@...
..@@@......@@..........@@.................@..@...@@..@.......@....@@@......@@..........@@.............@@@......@@..........@@.................@..@...@@..@......
@..@........@..@.@...@....@.......@......@...@...........@......@..@........@..@.@...@....@.......@.@..@........@..@.@...@....@.......@......@...@...........@..
.....@.@.......@.@@......@.....@..@...@......@@@.....@.......@@......@.@.......@.@@......@.....@..@......@.@.......@.@@......@.....@..@...@......@@@.....@......
..@....@...@@....@.@.@@@........@...@.@.......@.....@.....@.......@....@...@@....@.@.@@@........@.....@....@...@@....@.@.@@@........@...@.@.......@.....@.....@.
.............@@.....@@...@.......@@.@....@.@.....@@.@@.......@...............@@.....@@...@.......@@..............@@.....@@...@.......@@.@....@.@.....@@.@@......
..@.......@......@......@...........@@.@..........@.@@..@..@......@.......@......@......@.............@.......@......@......@...........@@.@..........@.@@..@..@
.....@....@@..@...@...@.......@......@....@..@@....@...@.@...........@....@@..@...@...@.......@..........@....@@..@...@...@.......@......@....@..@@....@...@.@..
..@.......@..@.............@.@@......@@.@...@.........@........@..@.......@..@.............@.@@.......@.......@..@.............@.@@......@@.@...@.........@.....
@@...@....@.@..@.@..@..@..@.@.@...@@@...@.@......@..@....@....@.@@...@....@.@..@.@..@..@..@.@.@...@@@@...@....@.@..@.@..@..@..@.@.@...@@@...@.@......@..@....@..
.....@.......@.......@..@..........@@@............@.....@.@.@........@.......@.......@..@..........@.....@.......@.......@..@..........@@@............@.....@.@.
...@....@......@.@...@..@..@.....@@@@@...@.....@..@.@..@...@.......@....@......@.@...@..@..@.....@@@...@....@......@.@...@..@..@.....@@@@@...@.....@..@.@..@...@
.....@.....@...@...@@...@...@@..@...@..............@...@...@.@@......@.....@...@...@@...@...@@..@........@.....@...@...@@...@...@@..@...@..............@...@...@
.......@....@.@@...@@.@@........@....@.@.@@@..@....@....@@..@..........@....@.@@...@@.@@........@..........@....@.@@...@@.@@........@....@.@.@@@..@....@....@@..
......@....@@....@@.@.@....@.@.@..@.@......@...@.....@@...............@....@@....@@.@.@....@.@.@..@.......@....@@....@@.@.@....@.@.@..@.@......@...@.....@@.....
.......@@..@...........@....@....@......@..@..@...@.@.@@@......@.......@@..@...........@....@....@.........@@..@...........@....@....@......@..@..@...@.@.@@@...
.@.........@....@..@.....@.........@@..@.....@.....@...@..@......@.........@....@..@.....@.........@.@.........@....@..@.....@.........@@..@.....@.....@...@..@.
@.@...@...@...@...@@@@@.@..@@....................@.@@...@....@..@.@...@...@...@...@@@@@.@..@@.......@.@...@...@...@...@@@@@.@..@@....................@.@@...@...
@..........@@.....@..@...@........@@.@.@....@..@@...............@..........@@.....@..@...@........@@@..........@@.....@..@...@........@@.@.@....@..@@...........
@.@....@...............@........@..@.@@@.............@@.@.......@.@....@...............@........@..@@.@....@...............@........@..@.@@@.............@@.@...
......@..@...@@@.@..@....@..@....@...............@..........@@........@..@...@@@.@..@....@..@....@........@..@...@@@.@..@....@..@....@...............@..........
..@.....@@..@.................@.........@...@...@.@.@.@...........@.....@@..@.................@.......@.....@@..@.................@.........@...@...@.@.@.@.....
...@.@........@..........@@..@.....@@......@...@...@...............@.@........@..........@@..@.....@...@.@........@..........@@..@.....@@......@...@...@........
...............@@....@.@...@............@...@.....@.....@@@....@...............@@....@.@...@.......................@@....@.@...@............@...@.....@.....@@@.
..@....@..@................@.......@@@......@........@.......@@@..@....@..@................@.......@..@....@..@................@.......@@@......@........@......
.....@@..@.@....@.............@.@...@......@.....@@.@................@@..@.@....@.............@.@........@@..@.@....@.............@.@...@......@.....@@.@.......
..@......@....@..@.@.@...@@...@....@...........@@@..@..@..@....@..@......@....@..@.@.@...@@...@....@..@......@....@..@.@.@...@@...@....@...........@@@..@..@..@.
...@@@.@.....@.@....@...@@...@...............@.@....@....@.....@...@@@.@.....@.@....@...@@...@.........@@@.@.....@.@....@...@@...@...............@.@....@....@..
@@.@...@.....@.....@.....@.............@@@..@...@......@........@@.@...@.....@.....@.....@..........@@.@...@.....@.....@.....@.............@@@..@...@......@....
..........@...@@........@...@...@....@.........@.........@................@...@@........@...@...@.............@...@@........@...@...@....@.........@.........@..
....@.......@..@..............@.........................@...@@......@.......@..@..............@.........@.......@..@..............@.........................@...
........@.@@..@............@@.@@@...@....@..@..@.@@.@..@@.@..@.@........@.@@..@............@@.@@@...........@.@@..@............@@.@@@...@....@..@..@.@@.@..@@.@.
.@..@@@...........@..............@...@..........@@@@......@..@...@..@@@...........@..............@...@..@@@...........@..............@...@..........@@@@......@.
.@....@...@.....@@.....@....@...@....@.........@..@@@.....@@...@.@....@...@.....@@.....@....@...@....@....@...@.....@@.....@....@...@....@.........@..@@@.....@@
.......@...........@...@...........@@..................................@...........@...@...........@.......@...........@...@...........@@.......................
.......@@....@....@..@..@..@@.....@.@.......@......@..@@@@....@........@@....@....@..@..@..@@.....@........@@....@....@..@..@..@@.....@.@.......@......@..@@@@..
.......@.........@.@..@.@........@............@........@...@...........@.........@.@..@.@........@.........@.........@.@..@.@........@............@........@...@
...@.............@.............@....@.@......@...@.............@...@.............@.............@.......@.............@.............@....@.@......@...@..........
..............@@..@@......@..@..................@....@..@....@................@@..@@......@..@....................@@..@@......@..@..................@....@..@...
@.@....@..@..@.@..@.@@.....................@@...............@@..@.@....@..@..@.@..@.@@..............@.@....@..@..@.@..@.@@.....................@@...............
.@.......@..........@.@@........@..@@.....@@@......@.....@.......@.......@..........@.@@........@..@.@.......@..........@.@@........@..@@.....@@@......@.....@..
...@..@...@..@...@..@.....@..............@.@.@....@..@....@........@..@...@..@...@..@.....@............@..@...@..@...@..@.....@..............@.@.@....@..@....@.
........@@............@.....@........@@.................................@@............@.....@...............@@............@.....@........@@.....................
..@....@..............@...................@.....@.....@@..........@....@..............@...............@....@..............@...................@.....@.....@@....
....@.@.......@..@.@...........@.......................@.....@@.....@.@.......@..@.@...........@........@.@.......@..@.@...........@.......................@....
.@.....@@...........@@.@.@.@.@.@@...@..@.@.......@@.........@....@.....@@...........@@.@.@.@.@.@@....@.....@@...........@@.@.@.@.@.@@...@..@.@.......@@.........
...@...@.@@....@.........@@...@.....@...................@..@@......@...@.@@....@.........@@...@........@...@.@@....@.........@@...@.....@...................@..@
@.@@.@....@.......@.............@..@....@...............@.......@.@@.@....@.......@.............@..@@.@@.@....@.......@.............@..@....@...............@...
.....@................@@....@.@.......@@........@..@....@.....@......@................@@....@.@..........@................@@....@.@.......@@........@..@....@...
..@@......@.@.@.....@...@@..@.@.....@......................@...@..@@......@.@.@.....@...@@..@.@.......@@......@.@.@.....@...@@..@.@.....@......................@
@@....@...@................@.............@.......@...@...@..@..@@@....@...@................@........@@....@...@................@.............@.......@...@...@..
...................@.@.........@@.....@.....@.....@....@.....@.....................@.@.........@@......................@.@.........@@.....@.....@.....@....@....
@.@@....@.@..@.@..@..@..........@......@.@..@..@...@..@.........@.@@....@.@..@.@..@..@..........@...@.@@....@.@..@.@..@..@..........@......@.@..@..@...@..@.....
@.....@................@.@.@.....@@.@...@..@.....@..@...........@.....@................@.@.@.....@@.@.....@................@.@.@.....@@.@...@..@.....@..@.......
.............@..@@...@..@...@@@@.....@..@.......@...@....@@....@.............@..@@...@..@...@@@@.................@..@@...@..@...@@@@.....@..@.......@...@....@@.
@.@.......@...@..@...........@............@....@..@..@.@........@.@.......@...@..@...........@......@.@.......@...@..@...........@............@....@..@..@.@....
......@..@...@@@.@..@....@..@....@...............@..........@@........@..@...@@@.@..@....@..@....@........@..@...@@@.@..@....@..@....@...............@..........
..@.....@@..@.................@.........@...@...@.@.@.@...........@.....@@..@.................@.......@.....@@..@.................@.........@...@...@.@.@.@.....
...@.@........@..........@@..@.....@@......@...@...@...............@.@........@..........@@..@.....@...@.@........@..........@@..@.....@@......@...@...@........
...............@@....@.@...@............@...@.....@.....@@@....@...............@@....@.@...@.......................@@....@.@...@............@...@.....@.....@@@.
..@....@..@................@.......@@@......@........@.......@@@..@....@..@................@.......@..@....@..@................@.......@@@......@........@......
.....@@..@.@....@.............@.@...@......@.....@@.@................@@..@.@....@.............@.@........@@..@.@....@.............@.@...@......@.....@@.@.......
..@......@....@..@.@.@...@@...@....@...........@@@..@..@..@....@..@......@....@..@.@.@...@@...@....@..@......@....@..@.@.@...@@...@....@...........@@@..@..@..@.
...@@@.@.....@.@....@...@@...@...............@.@....@....@.....@...@@@.@.....@.@....@...@@...@.........@@@.@.....@.@....@...@@...@...............@.@....@....@..
@@.@...@.....@.....@.....@.............@@@..@...@......@........@@.@...@.....@.....@.....@..........@@.@...@.....@.....@.....@.............@@@..@...@......@....
..........@...@@........@...@...@....@.........@.........@................@...@@........@...@...@.............@...@@........@...@...@....@.........@.........@..
....@.......@..@..............@.........................@...@@......@.......@..@..............@.........@.......@..@..............@.........................@...
........@.@@..@............@@.@@@...@....@..@..@.@@.@..@@.@..@.@........@.@@..@............@@.@@@...........@.@@..@............@@.@@@...@....@..@..@.@@.@..@@.@.
.@..@@@...........@..............@...@..........@@@@......@..@...@..@@@...........@..............@...@..@@@...........@..............@...@..........@@@@......@.
.@....@...@.....@@.....@....@...@....@.........@..@@@.....@@...@.@....@...@.....@@.....@....@...@....@....@...@.....@@.....@....@...@....@.........@..@@@.....@@
.......@...........@...@...........@@..................................@...........@...@...........@.......@...........@...@...........@@.......................
.......@@....@....@..@..@..@@.....@.@.......@......@..@@@@....@........@@....@....@..@..@..@@.....@........@@....@....@..@..@..@@.....@.@.......@......@..@@@@..
.......@.........@.@..@.@........@............@........@...@...........@.........@.@..@.@........@.........@.........@.@..@.@........@............@........@...@
...@.............@.............@....@.@......@...@.............@...@.............@.............@.......@.............@.............@....@.@......@...@..........
..............@@..@@......@..@..................@....@..@....@................@@..@@......@..@....................@@..@@......@..@..................@....@..@...
@.@....@..@..@.@..@.@@.....................@@...............@@..@.@....@..@..@.@..@.@@..............@.@....@..@..@.@..@.@@.....................@@...............
.@.......@..........@.@@........@..@@.....@@@......@.....@.......@.......@..........@.@@........@..@.@.......@..........@.@@........@..@@.....@@@......@.....@..
...@..@...@..@...@..@.....@..............@.@.@....@..@....@........@..@...@..@...@..@.....@............@..@...@..@...@..@.....@..............@.@.@....@..@....@.
........@@............@.....@........@@.................................@@............@.....@...............@@............@.....@........@@.....................
..@....@..............@...................@.....@.....@@..........@....@..............@...............@....@..............@...................@.....@.....@@....
....@.@.......@..@.@...........@.......................@.....@@.....@.@.......@..@.@...........@........@.@.......@..@.@...........@.......................@....
.@.....@@...........@@.@.@.@.@.@@...@..@.@.......@@.........@....@.....@@...........@@.@.@.@.@.@@....@.....@@...........@@.@.@.@.@.@@...@..@.@.......@@.........
...@...@.@@....@.........@@...@.....@...................@..@@......@...@.@@....@.........@@...@........@...@.@@....@.........@@...@.....@...................@..@
@.@@.@....@.......@.............@..@....@...............@.......@.@@.@....@.......@.............@..@@.@@.@....@.......@.............@..@....@...............@...
.....@................@@....@.@.......@@........@..@....@.....@......@................@@....@.@..........@................@@....@.@.......@@........@..@....@...
..@@......@.@.@.....@...@@..@.@.....@......................@...@..@@......@.@.@.....@...@@..@.@.......@@......@.@.@.....@...@@..@.@.....@......................@
@@....@...@................@.............@.......@...@...@..@..@@@....@...@................@........@@....@...@................@.............@.......@...@...@..
...................@.@.........@@.....@.....@.....@....@.....@.....................@.@.........@@......................@.@.........@@.....@.....@.....@....@....
@.@@....@.@..@.@..@..@..........@......@.@..@..@...@..@.........@.@@....@.@..@.@..@..@..........@...@.@@....@.@..@.@..@..@..........@......@.@..@..@...@..@.....
@.....@................@.@.@.....@@.@...@..@.....@..@...........@.....@................@.@.@.....@@.@.....@................@.@.@.....@@.@...@..@.....@..@.......
.............@..@@...@..@...@@@@.....@..@.......@...@....@@....@.............@..@@...@..@...@@@@.................@..@@...@..@...@@@@.....@..@.......@...@....@@.
@.@.......@...@..@...........@..@.........@....@..@..@.@........@.@.......@...@..@...........@..@...@.@.......@...@..@...........@..@.........@....@..@..@.@....
@@@@..@..@...............@......@..........@...@...@.@..@..@@..@@@@@..@..@...............@......@...@@@@..@..@...............@......@..........@...@...@.@..@..@
@@....@...............@.....@..@..@@......@@...............@@...@@....@...............@.....@..@..@@@@....@...............@.....@..@..@@......@@...............@
@......@.@@.@..@@.@@@...@.......@......@.........@....@....@....@......@.@@.@..@@.@@@...@.......@...@......@.@@.@..@@.@@@...@.......@......@.........@....@....@
.........@@@........@@...........@.....@....@.@.@....@.@...@.............@@@........@@...........@...........@@@........@@...........@.....@....@.@.@....@.@...@
................@.@..@@.....@...@.@.@..@........@...@..........@................@.@..@@.....@...@.@.................@.@..@@.....@...@.@.@..@........@...@.......
...@..@..@.........@@.....@....@.........@..@...@@@...........@@...@..@..@.........@@.....@....@.......@..@..@.........@@.....@....@.........@..@...@@@.........
..@.....@...@............@..@......@....@......@.....@@@....@.@@..@.....@...@............@..@......@..@.....@...@............@..@......@....@......@.....@@@....
........@.....@@....@.....@.@.....@.....@.@..@..............@..@........@.....@@....@.....@.@.....@@........@.....@@....@.....@.@.....@.....@.@..@..............
...@.........@....@................@.@@...........@.....@...@......@.........@....@................@...@.........@....@................@.@@...........@.....@...
..@@@......@@..........@@.................@..@...@@..@.......@....@@@......@@..........@@.............@@@......@@..........@@.................@..@...@@..@......
@..@........@..@.@...@....@.......@......@...@...........@......@..@........@..@.@...@....@.......@.@..@........@..@.@...@....@.......@......@...@...........@..
.....@.@.......@.@@......@.....@..@...@......@@@.....@.......@@......@.@.......@.@@......@.....@..@......@.@.......@.@@......@.....@..@...@......@@@.....@......
..@....@...@@....@.@.@@@........@...@.@.......@.....@.....@.......@....@...@@....@.@.@@@........@.....@....@...@@....@.@.@@@........@...@.@.......@.....@.....@.
.............@@.....@@...@.......@@.@....@.@.....@@.@@.......@...............@@.....@@...@.......@@..............@@.....@@...@.......@@.@....@.@.....@@.@@......
..@.......@......@......@...........@@.@..........@.@@..@..@......@.......@......@......@.............@.......@......@......@...........@@.@..........@.@@..@..@
.....@....@@..@...@...@.......@......@....@..@@....@...@.@...........@....@@..@...@...@.......@..........@....@@..@...@...@.......@......@....@..@@....@...@.@..
..@.......@..@.............@.@@......@@.@...@.........@........@..@.......@..@.............@.@@.......@.......@..@.............@.@@......@@.@...@.........@.....
@@...@....@.@..@.@..@..@..@.@.@...@@@...@.@......@..@....@....@.@@...@....@.@..@.@..@..@..@.@.@...@@@@...@....@.@..@.@..@..@..@.@.@...@@@...@.@......@..@....@..
.....@.......@.......@..@..........@@@............@.....@.@.@........@.......@.......@..@..........@.....@.......@.......@..@..........@@@............@.....@.@.
...@....@......@.@...@..@..@.....@@@@@...@.....@..@.@..@...@.......@....@......@.@...@..@..@.....@@@...@....@......@.@...@..@..@.....@@@@@...@.....@..@.@..@...@
.....@.....@...@...@@...@...@@..@...@..............@...@...@.@@......@.....@...@...@@...@...@@..@........@.....@...@...@@...@...@@..@...@..............@...@...@
.......@....@.@@...@@.@@........@....@.@.@@@..@....@....@@..@..........@....@.@@...@@.@@........@..........@....@.@@...@@.@@........@....@.@.@@@..@....@....@@..
......@....@@....@@.@.@....@.@.@..@.@......@...@......@...............@....@@....@@.@.@....@.@.@..@.......@....@@....@@.@.@....@.@.@..@.@......@...@......@.....
.......@@..@...........@....@....@......@..@..@...@.@.@@@......@.......@@..@...........@....@....@.........@@..@...........@....@....@......@..@..@...@.@.@@@...
