type octile
height 90
width 90
map
......@..@...@@@.@..@....@..@....@...............@..........@@........@..@...@@@.@..@....@
..@.....@@..@.................@.........@...@...@.@.@.@...........@.....@@..@.............
...@.@........@..........@@..@.....@@......@...@...@...............@.@........@..........@
...............@@....@.@...@............@...@.....@.....@@@....@...............@@....@.@..
..@....@..@................@.......@@@......@........@.......@@@..@....@..@...............
.....@@..@.@....@.............@.@...@......@.....@@.@................@@..@.@....@.........
..@......@....@..@.@.@...@@...@....@...........@@@..@..@..@....@..@......@....@..@.@.@...@
...@@@.@.....@.@....@...@@...@...............@.@....@....@.....@...@@@.@.....@.@....@...@@
@@.@...@.....@.....@.....@.............@@@..@...@......@........@@.@...@.....@.....@.....@
..........@...@@........@...@...@....@.........@.........@................@...@@........@.
....@.......@..@..............@.........................@...@@......@.......@..@..........
........@.@@..@............@@.@@@...@....@..@..@.@@.@..@@.@..@.@........@.@@..@...........
.@..@@@...........@..............@...@..........@@@@......@..@...@..@@@...........@.......
.@....@...@.....@@.....@....@...@....@.........@..@@@.....@@...@.@....@...@.....@@.....@..
.......@...........@...@...........@@..................................@...........@...@..
.......@@....@....@..@..@..@@.....@.@.......@......@..@@@@....@........@@....@....@..@..@.
.......@.........@.@..@.@........@............@........@...@...........@.........@.@..@.@.
...@.............@.............@....@.@......@...@.............@...@.............@........
..............@@..@@......@..@..................@....@..@....@................@@..@@......
@.@....@..@..@.@..@.@@.....................@@...............@@..@.@....@..@..@.@..@.@@....
.@.......@..........@.@@........@..@@.....@@@......@.....@.......@.......@..........@.@@..
...@..@...@..@...@..@.....@..............@.@.@....@..@....@........@..@...@..@...@..@.....
........@@............@.....@........@@.................................@@............@...
..@....@..............@...................@.....@.....@@..........@....@..............@...
....@.@.......@..@.@...........@.......................@.....@@.....@.@.......@..@.@......
.@.....@@...........@@.@.@.@.@.@@...@..@.@.......@@.........@....@.....@@...........@@.@.@
...@...@.@@....@.........@@...@.....@...................@..@@......@...@.@@....@.........@
@.@@.@....@.......@.............@..@....@...............@.......@.@@.@....@.......@.......
.....@................@@....@.@.......@@........@..@....@.....@......@................@@..
..@@......@.@.@.....@...@@..@.@.....@......................@...@..@@......@.@.@.....@...@@
@@....@...@................@.............@.......@...@...@..@..@@@....@...@...............
...................@.@.........@@.....@.....@.....@....@.....@.....................@.@....
@.@@....@.@..@.@..@..@..........@......@.@..@..@...@..@.........@.@@....@.@..@.@..@..@....
@.....@................@.@.@.....@@.@...@..@.....@..@...........@.....@................@.@
.............@..@@...@..@...@@@@.....@..@.......@...@....@@....@.............@..@@...@..@.
@.@.......@...@..@...........@..@.........@....@..@..@.@........@.@.......@...@..@........
@@@@..@..@...............@......@..........@...@...@.@..@..@@..@@@@@..@..@...............@
@@....@...............@.....@..@..@@......@@...............@@...@@....@...............@...
@......@.@@.@..@@.@@@...@.......@......@.........@....@....@....@......@.@@.@..@@.@@@...@.
.........@@@........@@...........@.....@....@.@.@....@.@...@.............@@@........@@....
................@.@..@@.....@...@.@.@..@........@...@..........@................@.@..@@...
...@..@..@.........@@.....@....@.........@..@...@@@...........@@...@..@..@.........@@.....
..@.....@...@............@..@......@....@......@.....@@@....@.@@..@.....@...@............@
........@.....@@....@.....@.@.....@.....@.@..@..............@..@........@.....@@....@.....
...@.........@....@................@.@@...........@.....@...@......@.........@....@.......
..@@@......@@..........@@.................@..@...@@..@.......@....@@@......@@..........@@.
@..@........@..@.@...@....@.......@......@...@...........@......@..@........@..@.@...@....
.....@.@.......@.@@......@.....@..@...@......@@@.....@.......@@......@.@.......@.@@......@
..@....@...@@....@.@.@@@........@...@.@.......@.....@.....@.......@....@...@@....@.@.@@@..
.............@@.....@@...@.......@@.@....@.@.....@@.@@.......@...............@@.....@@...@
..@.......@......@......@...........@@.@..........@.@@..@..@......@.......@......@......@.
.....@....@@..@...@...@.......@......@....@..@@....@...@.@...........@....@@..@...@...@...
..@.......@..@.............@.@@......@@.@...@.........@........@..@.......@..@............
@@...@....@.@..@.@..@..@..@.@.@...@@@...@.@......@..@....@....@.@@...@....@.@..@.@..@..@..
.....@.......@.......@..@..........@@@............@.....@.@.@........@.......@.......@..@.
...@....@......@.@...@..@..@.....@@@@@...@.....@..@.@..@...@.......@....@......@.@...@..@.
.....@.....@...@...@@...@...@@..@...@..............@...@...@.@@......@.....@...@...@@...@.
.......@....@.@@...@@.@@........@....@.@.@@@..@....@....@@..@..........@....@.@@...@@.@@..
......@....@@....@@.@.@....@.@.@..@.@......@...@.....@@...............@....@@....@@.@.@...
.......@@..@...........@....@....@......@..@..@...@.@.@@@......@.......@@..@...........@..
.@.........@....@..@.....@.........@@..@.....@.....@...@..@......@.........@....@..@.....@
@.@...@...@...@...@@@@@.@..@@....................@.@@...@....@..@.@...@...@...@...@@@@@.@@
@..........@@.....@..@...@........@@.@.@....@..@@...............@..........@@.....@..@...@
@.@....@...............@........@..@.@@@.............@@.@.......@.@....@...............@..
......@..@...@@@.@..@....@..@....@...............@..........@@........@..@...@@@.@..@....@
..@.....@@..@.................@.........@...@...@.@.@.@...........@.....@@..@.............
...@.@........@..........@@..@.....@@......@...@...@...............@.@........@..........@
...............@@....@.@...@............@...@.....@.....@@@....@...............@@....@.@..
..@....@..@................@.......@@@......@........@.......@@@..@....@..@...............
.....@@..@.@....@.............@.@...@......@.....@@.@................@@..@.@....@.........
..@......@....@..@.@.@...@@...@....@...........@@@..@..@..@....@..@......@....@..@.@.@...@
...@@@.@.....@.@....@...@@...@...............@.@....@....@.....@...@@@.@.....@.@....@...@@
@@.@...@.....@.....@.....@.............@@@..@...@......@........@@.@...@.....@.....@.....@
..........@...@@........@...@...@....@.........@.........@................@...@@........@.
....@.......@..@..............@.........................@...@@......@.......@..@..........
........@.@@..@............@@.@@@...@....@..@..@.@@.@..@@.@..@.@........@.@@..@...........
.@..@@@...........@..............@...@..........@@@@......@..@...@..@@@...........@.......
.@....@...@.....@@.....@....@...@....@.........@..@@@.....@@...@.@....@...@.....@@.....@..
.......@...........@...@...........@@..................................@...........@...@..
.......@@....@....@..@..@..@@.....@.@.......@......@..@@@@....@........@@....@....@..@..@.
.......@.........@.@..@.@........@............@........@...@...........@.........@.@..@.@.
...@.............@.............@....@.@......@...@.............@...@.............@........
..............@@..@@......@..@..................@....@..@....@................@@..@@......
@.@....@..@..@.@..@.@@.....................@@...............@@..@.@....@..@..@.@..@.@@....
.@.......@..........@.@@........@..@@.....@@@......@.....@.......@.......@..........@.@@..
...@..@...@..@...@..@.....@..............@.@.@....@..@....@........@..@...@..@...@..@.....
........@@............@.....@........@@.................................@@............@...
..@....@..............@...................@.....@.....@@..........@....@..............@...
....@.@.......@..@.@...........@.......................@.....@@.....@.@.......@..@.@......
.@.....@@...........@@.@.@.@.@.@@...@..@.@.......@@.........@....@.....@@...........@@.@.@
