type octile
height 22
width 18
map
..................
....TTTTTTTTTT....
....TTTTTTTTTT....
..................
....TTTTTTTTTT....
....TTTTTTTTTT....
..................
....TTTTTTTTTT....
....TTTTTTTTTT....
..................
....TTTTTTTTTT....
....TTTTTTTTTT....
..................
....TTTTTTTTTT....
....TTTTTTTTTT....
..................
....TTTTTTTTTT....
....TTTTTTTTTT....
..................
....TTTTTTTTTT....
....TTTTTTTTTT....
..................

