type octile
height 110
width 110
map
......@..@...@@@.@..@....@..@....@...............@..........@@........@..@...@@@.@..@....@..@....@........@..@
..@.....@@..@.................@.........@...@...@.@.@.@...........@.....@@..@.................@.......@.....@@
...@.@........@..........@@..@.....@@......@...@...@...............@.@........@..........@@..@.....@...@.@....
...............@@....@.@...@............@...@.....@.....@@@....@...............@@....@.@...@..................
..@....@..@................@.......@@@......@........@.......@@@..@....@..@................@.......@..@....@..
.....@@..@.@....@.............@.@...@......@.....@@.@................@@..@.@....@.............@.@........@@..@
..@......@....@..@.@.@...@@...@....@...........@@@..@..@..@....@..@......@....@..@.@.@...@@...@....@..@......@
...@@@.@.....@.@....@...@@...@...............@.@....@....@.....@...@@@.@.....@.@....@...@@...@.........@@@.@..
@@.@...@.....@.....@.....@.............@@@..@...@......@........@@.@...@.....@.....@.....@..........@@.@...@..
..........@...@@........@...@...@....@.........@.........@................@...@@........@...@...@.............
....@.......@..@..............@.........................@...@@......@.......@..@..............@.........@.....
........@.@@..@............@@.@@@...@....@..@..@.@@.@..@@.@..@.@........@.@@..@............@@.@@@...........@.
.@..@@@...........@..............@...@..........@@@@......@..@...@..@@@...........@..............@...@..@@@...
.@....@...@.....@@.....@....@...@....@.........@..@@@.....@@...@.@....@...@.....@@.....@....@...@....@....@...
.......@...........@...@...........@@..................................@...........@...@...........@.......@..
.......@@....@....@..@..@..@@.....@.@.......@......@..@@@@....@........@@....@....@..@..@..@@.....@........@@.
.......@.........@.@..@.@........@............@........@...@...........@.........@.@..@.@........@.........@..
...@.............@.............@....@.@......@...@.............@...@.............@.............@.......@......
..............@@..@@......@..@..................@....@..@....@................@@..@@......@..@................
@.@....@..@..@.@..@.@@.....................@@...............@@..@.@....@..@..@.@..@.@@..............@.@....@..
.@.......@..........@.@@........@..@@.....@@@......@.....@.......@.......@..........@.@@........@..@.@.......@
...@..@...@..@...@..@.....@..............@.@.@....@..@....@........@..@...@..@...@..@.....@............@..@...
........@@............@.....@........@@.................................@@............@.....@...............@@
..@....@..............@...................@.....@.....@@..........@....@..............@...............@....@..
....@.@.......@..@.@...........@.......................@.....@@.....@.@.......@..@.@...........@........@.....
.@.....@@...........@@.@.@.@.@.@@...@..@.@.......@@.........@....@.....@@...........@@.@.@.@.@.@@....@.....@@.
...@...@.@@....@.........@@...@.....@...................@..@@......@...@.@@....@.........@@...@........@...@.@
@.@@.@....@.......@.............@..@....@...............@.......@.@@.@....@.......@.............@..@@.@@.@....
.....@................@@....@.@.......@@........@..@....@.....@......@................@@....@.@..........@....
..@@......@.@.@.....@...@@..@.@.....@......................@...@..@@......@.@.@.....@...@@..@.@.......@@......
@@....@...@................@.............@.......@...@...@..@..@@@....@...@................@........@@....@...
...................@.@.........@@.....@.....@.....@....@.....@.....................@.@.........@@.............
@.@@....@.@..@.@..@..@..........@......@.@..@..@...@..@.........@.@@....@.@..@.@..@..@..........@...@.@@....@.
@.....@................@.@.@.....@@.@...@..@.....@..@...........@.....@................@.@.@.....@@.@.....@...
.............@..@@...@..@...@@@@.....@..@.......@...@....@@....@.............@..@@...@..@...@@@@..............
@.@.......@...@..@...........@..@.........@....@..@..@.@........@.@.......@...@..@...........@..@...@.@.......
@@@@..@..@...............@......@..........@...@...@.@..@..@@..@@@@@..@..@...............@......@...@@@@..@..@
@@....@...............@.....@..@..@@......@@...............@@...@@....@...............@.....@..@..@@@@....@...
@......@.@@.@..@@.@@@...@.......@......@.........@....@....@....@......@.@@.@..@@.@@@...@.......@...@......@.@
.........@@@........@@...........@.....@....@.@.@....@.@...@.............@@@........@@...........@...........@
................@.@..@@.....@...@.@.@..@........@...@..........@................@.@..@@.....@...@.@...........
...@..@..@.........@@.....@....@.........@..@...@@@...........@@...@..@..@.........@@.....@....@.......@..@..@
..@.....@...@............@..@......@....@......@.....@@@....@.@@..@.....@...@............@..@......@..@.....@.
........@.....@@....@.....@.@.....@.....@.@..@..............@..@........@.....@@....@.....@.@.....@@........@.
...@.........@....@................@.@@...........@.....@...@......@.........@....@................@...@......
..@@@......@@..........@@.................@..@...@@..@.......@....@@@......@@..........@@.............@@@.....
@..@........@..@.@...@....@.......@......@...@...........@......@..@........@..@.@...@....@.......@.@..@......
.....@.@.......@.@@......@.....@..@...@......@@@.....@.......@@......@.@.......@.@@......@.....@..@......@.@..
..@....@...@@....@.@.@@@........@...@.@.......@.....@.....@.......@....@...@@....@.@.@@@........@.....@....@..
.............@@.....@@...@.......@@.@....@.@.....@@.@@.......@...............@@.....@@...@.......@@...........
..@.......@......@......@...........@@.@..........@.@@..@..@......@.......@......@......@.............@.......
.....@....@@..@...@...@.......@......@....@..@@....@...@.@...........@....@@..@...@...@.......@..........@....
..@.......@..@.............@.@@......@@.@...@.........@........@..@.......@..@.............@.@@.......@.......
@@...@....@.@..@.@..@..@..@.@.@...@@@...@.@......@..@....@....@.@@...@....@.@..@.@..@..@..@.@.@...@@@@...@....
.....@.......@.......@..@..........@@@............@.....@.@.@........@.......@.......@..@..........@.....@....
...@....@......@.@...@..@..@.....@@@@@...@.....@..@.@..@...@.......@....@......@.@...@..@..@.....@@@...@....@.
.....@.....@...@...@@...@...@@..@...@..............@...@...@.@@......@.....@...@...@@...@...@@..@........@....
.......@....@.@@...@@.@@........@....@.@.@@@..@....@....@@..@..........@....@.@@...@@.@@........@..........@..
......@....@@....@@.@.@....@.@.@..@.@......@...@.....@@...............@....@@....@@.@.@....@.@.@..@.......@...
.......@@..@...........@....@....@......@..@..@...@.@.@@@......@.......@@..@...........@....@....@.........@@.
.@.........@....@..@.....@.........@@..@.....@.....@...@..@......@.........@....@..@.....@.........@.@........
@.@...@...@...@...@@@@@.@..@@....................@.@@...@....@..@.@...@...@...@...@@@@@.@..@@.......@.@...@...
@..........@@.....@..@...@........@@.@.@....@..@@...............@..........@@.....@..@...@........@@@.........
@.@....@...............@........@..@.@@@.............@@.@.......@.@....@...............@........@..@@.@....@..
......@..@...@@@.@..@....@..@....@...............@..........@@........@..@...@@@.@..@....@..@....@........@..@
..@.....@@..@.................@.........@...@...@.@.@.@...........@.....@@..@.................@.......@.....@@
...@.@........@..........@@..@.....@@......@...@...@...............@.@........@..........@@..@.....@...@.@....
...............@@....@.@...@............@...@.....@.....@@@....@...............@@....@.@...@..................
..@....@..@................@.......@@@......@........@.......@@@..@....@..@................@.......@..@....@..
.....@@..@.@....@.............@.@...@......@.....@@.@................@@..@.@....@.............@.@........@@..@
..@......@....@..@.@.@...@@...@....@...........@@@..@..@..@....@..@......@....@..@.@.@...@@...@....@..@......@
...@@@.@.....@.@....@...@@...@...............@.@....@....@.....@...@@@.@.....@.@....@...@@...@.........@@@.@..
@@.@...@.....@.....@.....@.............@@@..@...@......@........@@.@...@.....@.....@.....@..........@@.@...@..
..........@...@@........@...@...@....@.........@.........@................@...@@........@...@...@.............
....@.......@..@..............@.........................@...@@......@.......@..@..............@.........@.....
........@.@@..@............@@.@@@...@....@..@..@.@@.@..@@.@..@.@........@.@@..@............@@.@@@...........@.
.@..@@@...........@..............@...@..........@@@@......@..@...@..@@@...........@..............@...@..@@@...
.@....@...@.....@@.....@....@...@....@.........@..@@@.....@@...@.@....@...@.....@@.....@....@...@....@....@...
.......@...........@...@...........@@..................................@...........@...@...........@.......@..
.......@@....@....@..@..@..@@.....@.@.......@......@..@@@@....@........@@....@....@..@..@..@@.....@........@@.
.......@.........@.@..@.@........@............@........@...@...........@.........@.@..@.@........@.........@..
...@.............@.............@....@.@......@...@.............@...@.............@.............@.......@......
..............@@..@@......@..@..................@....@..@....@................@@..@@......@..@................
@.@....@..@..@.@..@.@@.....................@@...............@@..@.@....@..@..@.@..@.@@..............@.@....@..
.@.......@..........@.@@........@..@@.....@@@......@.....@.......@.......@..........@.@@........@..@.@.......@
...@..@...@..@...@..@.....@..............@.@.@....@..@....@........@..@...@..@...@..@.....@............@..@...
........@@............@.....@........@@.................................@@............@.....@...............@@
..@....@..............@...................@.....@.....@@..........@....@..............@...............@....@..
....@.@.......@..@.@...........@.......................@.....@@.....@.@.......@..@.@...........@........@.....
.@.....@@...........@@.@.@.@.@.@@...@..@.@.......@@.........@....@.....@@...........@@.@.@.@.@.@@....@.....@@.
...@...@.@@....@.........@@...@.....@...................@..@@......@...@.@@....@.........@@...@........@...@.@
@.@@.@....@.......@.............@..@....@...............@.......@.@@.@....@.......@.............@..@@.@@.@....
.....@................@@....@.@.......@@........@..@....@.....@......@................@@....@.@..........@....
..@@......@.@.@.....@...@@..@.@.....@......................@...@..@@......@.@.@.....@...@@..@.@.......@@......
@@....@...@................@.............@.......@...@...@..@..@@@....@...@................@........@@....@...
...................@.@.........@@.....@.....@.....@....@.....@.....................@.@.........@@.............
@.@@....@.@..@.@..@..@..........@......@.@..@..@...@..@.........@.@@....@.@..@.@..@..@..........@...@.@@....@.
@.....@................@.@.@.....@@.@...@..@.....@..@...........@.....@................@.@.@.....@@.@.....@...
.............@..@@...@..@...@@@@.....@..@.......@...@....@@....@.............@..@@...@..@...@@@@..............
@.@.......@...@..@...........@............@....@..@..@.@........@.@.......@...@..@...........@......@.@.......
......@..@...@@@.@..@....@..@....@...............@..........@@........@..@...@@@.@..@....@..@....@........@..@
..@.....@@..@.................@.........@...@...@.@.@.@...........@.....@@..@.................@.......@.....@@
...@.@........@..........@@..@.....@@......@...@...@...............@.@........@..........@@..@.....@...@.@....
...............@@....@.@...@............@...@.....@.....@@@....@...............@@....@.@...@..................
..@....@..@................@.......@@@......@........@.......@@@..@....@..@................@.......@..@....@..
.....@@..@.@....@.............@.@...@......@.....@@.@................@@..@.@....@.............@.@........@@..@
..@......@....@..@.@.@...@@...@....@...........@@@..@..@..@....@..@......@....@..@.@.@...@@...@....@..@......@
...@@@.@.....@.@....@...@@...@...............@.@....@....@.....@...@@@.@.....@.@....@...@@...@.........@@@.@..
@@.@...@.....@.....@.....@.............@@@..@...@......@........@@.@...@.....@.....@.....@..........@@.@...@..
..........@...@@........@...@...@....@.........@.........@................@...@@........@...@...@.............
