type octile
height 140
width 140
map
......@..@...@@@.@..@....@..@....@...............@..........@@........@..@...@@@.@..@....@..@....@........@..@...@@@.@..@....@..@....@......
..@.....@@..@.................@.........@...@...@.@.@.@...........@.....@@..@.................@.......@.....@@..@.................@.........
...@.@........@..........@@..@.....@@......@...@...@...............@.@........@..........@@..@.....@...@.@........@..........@@..@.....@@...
...............@@....@.@...@............@...@.....@.....@@@....@...............@@....@.@...@.......................@@....@.@...@............
..@....@..@................@.......@@@......@........@.......@@@..@....@..@................@.......@..@....@..@................@.......@@@..
.....@@..@.@....@.............@.@...@......@.....@@.@................@@..@.@....@.............@.@........@@..@.@....@.............@.@...@...
..@......@....@..@.@.@...@@...@....@...........@@@..@..@..@....@..@......@....@..@.@.@...@@...@....@..@......@....@..@.@.@...@@...@....@....
...@@@.@.....@.@....@...@@...@...............@.@....@....@.....@...@@@.@.....@.@....@...@@...@.........@@@.@.....@.@....@...@@...@..........
@@.@...@.....@.....@.....@.............@@@..@...@......@........@@.@...@.....@.....@.....@..........@@.@...@.....@.....@.....@.............@
..........@...@@........@...@...@....@.........@.........@................@...@@........@...@...@.............@...@@........@...@...@....@..
....@.......@..@..............@.........................@...@@......@.......@..@..............@.........@.......@..@..............@.........
........@.@@..@............@@.@@@...@....@..@..@.@@.@..@@.@..@.@........@.@@..@............@@.@@@...........@.@@..@............@@.@@@...@...
.@..@@@...........@..............@...@..........@@@@......@..@...@..@@@...........@..............@...@..@@@...........@..............@...@..
.@....@...@.....@@.....@....@...@....@.........@..@@@.....@@...@.@....@...@.....@@.....@....@...@....@....@...@.....@@.....@....@...@....@..
.......@...........@...@...........@@..................................@...........@...@...........@.......@...........@...@...........@@...
.......@@....@....@..@..@..@@.....@.@.......@......@..@@@@....@........@@....@....@..@..@..@@.....@........@@....@....@..@..@..@@.....@.@...
.......@.........@.@..@.@........@............@........@...@...........@.........@.@..@.@........@.........@.........@.@..@.@........@......
...@.............@.............@....@.@......@...@.............@...@.............@.............@.......@.............@.............@....@.@.
..............@@..@@......@..@..................@....@..@....@................@@..@@......@..@....................@@..@@......@..@..........
@.@....@..@..@.@..@.@@.....................@@...............@@..@.@....@..@..@.@..@.@@..............@.@....@..@..@.@..@.@@..................
.@.......@..........@.@@........@..@@.....@@@......@.....@.......@.......@..........@.@@........@..@.@.......@..........@.@@........@..@@...
...@..@...@..@...@..@.....@..............@.@.@....@..@....@........@..@...@..@...@..@.....@............@..@...@..@...@..@.....@.............
........@@............@.....@........@@.................................@@............@.....@...............@@............@.....@........@@.
..@....@..............@...................@.....@.....@@..........@....@..............@...............@....@..............@.................
....@.@.......@..@.@...........@.......................@.....@@.....@.@.......@..@.@...........@........@.@.......@..@.@...........@........
.@.....@@...........@@.@.@.@.@.@@...@..@.@.......@@.........@....@.....@@...........@@.@.@.@.@.@@....@.....@@...........@@.@.@.@.@.@@...@..@
...@...@.@@....@.........@@...@.....@...................@..@@......@...@.@@....@.........@@...@........@...@.@@....@.........@@...@.....@...
@.@@.@....@.......@.............@..@....@...............@.......@.@@.@....@.......@.............@..@@.@@.@....@.......@.............@..@....
.....@................@@....@.@.......@@........@..@....@.....@......@................@@....@.@..........@................@@....@.@.......@@
..@@......@.@.@.....@...@@..@.@.....@......................@...@..@@......@.@.@.....@...@@..@.@.......@@......@.@.@.....@...@@..@.@.....@...
@@....@...@................@.............@.......@...@...@..@..@@@....@...@................@........@@....@...@................@............
...................@.@.........@@.....@.....@.....@....@.....@.....................@.@.........@@......................@.@.........@@.....@.
@.@@....@.@..@.@..@..@..........@......@.@..@..@...@..@.........@.@@....@.@..@.@..@..@..........@...@.@@....@.@..@.@..@..@..........@......@
@.....@................@.@.@.....@@.@...@..@.....@..@...........@.....@................@.@.@.....@@.@.....@................@.@.@.....@@.@...
.............@..@@...@..@...@@@@.....@..@.......@...@....@@....@.............@..@@...@..@...@@@@.................@..@@...@..@...@@@@.....@..
@.@.......@...@..@...........@..@.........@....@..@..@.@........@.@.......@...@..@...........@..@...@.@.......@...@..@...........@..@.......
@@@@..@..@...............@......@..........@...@...@.@..@..@@..@@@@@..@..@...............@......@...@@@@..@..@...............@......@.......
@@....@...............@.....@..@..@@......@@...............@@...@@....@...............@.....@..@..@@@@....@...............@.....@..@..@@....
@......@.@@.@..@@.@@@...@.......@......@.........@....@....@....@......@.@@.@..@@.@@@...@.......@...@......@.@@.@..@@.@@@...@.......@......@
.........@@@........@@...........@.....@....@.@.@....@.@...@.............@@@........@@...........@...........@@@........@@...........@.....@
................@.@..@@.....@...@.@.@..@........@...@..........@................@.@..@@.....@...@.@.................@.@..@@.....@...@.@.@..@
...@..@..@.........@@.....@....@.........@..@...@@@...........@@...@..@..@.........@@.....@....@.......@..@..@.........@@.....@....@........
..@.....@...@............@..@......@....@......@.....@@@....@.@@..@.....@...@............@..@......@..@.....@...@............@..@......@....
........@.....@@....@.....@.@.....@.....@.@..@..............@..@........@.....@@....@.....@.@.....@@........@.....@@....@.....@.@.....@.....
...@.........@....@................@.@@...........@.....@...@......@.........@....@................@...@.........@....@................@.@@.
..@@@......@@..........@@.................@..@...@@..@.......@....@@@......@@..........@@.............@@@......@@..........@@...............
@..@........@..@.@...@....@.......@......@...@...........@......@..@........@..@.@...@....@.......@.@..@........@..@.@...@....@.......@.....
.....@.@.......@.@@......@.....@..@...@......@@@.....@.......@@......@.@.......@.@@......@.....@..@......@.@.......@.@@......@.....@..@...@.
..@....@...@@....@.@.@@@........@...@.@.......@.....@.....@.......@....@...@@....@.@.@@@........@.....@....@...@@....@.@.@@@........@...@.@.
.............@@.....@@...@.......@@.@....@.@.....@@.@@.......@...............@@.....@@...@.......@@..............@@.....@@...@.......@@.@...
..@.......@......@......@...........@@.@..........@.@@..@..@......@.......@......@......@.............@.......@......@......@...........@@.@
.....@....@@..@...@...@.......@......@....@..@@....@...@.@...........@....@@..@...@...@.......@..........@....@@..@...@...@.......@......@..
..@.......@..@.............@.@@......@@.@...@.........@........@..@.......@..@.............@.@@.......@.......@..@.............@.@@......@@.
@@...@....@.@..@.@..@..@..@.@.@...@@@...@.@......@..@....@....@.@@...@....@.@..@.@..@..@..@.@.@...@@@@...@....@.@..@.@..@..@..@.@.@...@@@...
.....@.......@.......@..@..........@@@............@.....@.@.@........@.......@.......@..@..........@.....@.......@.......@..@..........@@@..
...@....@......@.@...@..@..@.....@@@@@...@.....@..@.@..@...@.......@....@......@.@...@..@..@.....@@@...@....@......@.@...@..@..@.....@@@@@..
.....@.....@...@...@@...@...@@..@...@..............@...@...@.@@......@.....@...@...@@...@...@@..@........@.....@...@...@@...@...@@..@...@...
.......@....@.@@...@@.@@........@....@.@.@@@..@....@....@@..@..........@....@.@@...@@.@@........@..........@....@.@@...@@.@@........@....@.@
......@....@@....@@.@.@....@.@.@..@.@......@...@.....@@...............@....@@....@@.@.@....@.@.@..@.......@....@@....@@.@.@....@.@.@..@.@...
.......@@..@...........@....@....@......@..@..@...@.@.@@@......@.......@@..@...........@....@....@.........@@..@...........@....@....@......
.@.........@....@..@.....@.........@@..@.....@.....@...@..@......@.........@....@..@.....@.........@.@.........@....@..@.....@.........@@..@
@.@...@...@...@...@@@@@.@..@@....................@.@@...@....@..@.@...@...@...@...@@@@@.@..@@.......@.@...@...@...@...@@@@@.@..@@...........
@..........@@.....@..@...@........@@.@.@....@..@@...............@..........@@.....@..@...@........@@@..........@@.....@..@...@........@@.@.@
@.@....@...............@........@..@.@@@.............@@.@.......@.@....@...............@........@..@@.@....@...............@........@..@.@@@
......@..@...@@@.@..@....@..@....@...............@..........@@........@..@...@@@.@..@....@..@....@........@..@...@@@.@..@....@..@....@......
..@.....@@..@.................@.........@...@...@.@.@.@...........@.....@@..@.................@.......@.....@@..@.................@.........
...@.@........@..........@@..@.....@@......@...@...@...............@.@........@..........@@..@.....@...@.@........@..........@@..@.....@@...
...............@@....@.@...@............@...@.....@.....@@@....@...............@@....@.@...@.......................@@....@.@...@............
..@....@..@................@.......@@@......@........@.......@@@..@....@..@................@.......@..@....@..@................@.......@@@..
.....@@..@.@....@.............@.@...@......@.....@@.@................@@..@.@....@.............@.@........@@..@.@....@.............@.@...@...
..@......@....@..@.@.@...@@...@....@...........@@@..@..@..@....@..@......@....@..@.@.@...@@...@....@..@......@....@..@.@.@...@@...@....@....
...@@@.@.....@.@....@...@@...@...............@.@....@....@.....@...@@@.@.....@.@....@...@@...@.........@@@.@.....@.@....@...@@...@..........
@@.@...@.....@.....@.....@.............@@@..@...@......@........@@.@...@.....@.....@.....@..........@@.@...@.....@.....@.....@.............@
..........@...@@........@...@...@....@.........@.........@................@...@@........@...@...@.............@...@@........@...@...@....@..
....@.......@..@..............@.........................@...@@......@.......@..@..............@.........@.......@..@..............@.........
........@.@@..@............@@.@@@...@....@..@..@.@@.@..@@.@..@.@........@.@@..@............@@.@@@...........@.@@..@............@@.@@@...@...
.@..@@@...........@..............@...@..........@@@@......@..@...@..@@@...........@..............@...@..@@@...........@..............@...@..
.@....@...@.....@@.....@....@...@....@.........@..@@@.....@@...@.@....@...@.....@@.....@....@...@....@....@...@.....@@.....@....@...@....@..
.......@...........@...@...........@@..................................@...........@...@...........@.......@...........@...@...........@@...
.......@@....@....@..@..@..@@.....@.@.......@......@..@@@@....@........@@....@....@..@..@..@@.....@........@@....@....@..@..@..@@.....@.@...
.......@.........@.@..@.@........@............@........@...@...........@.........@.@..@.@........@.........@.........@.@..@.@........@......
...@.............@.............@....@.@......@...@.............@...@.............@.............@.......@.............@.............@....@.@.
..............@@..@@......@..@..................@....@..@....@................@@..@@......@..@....................@@..@@......@..@..........
@.@....@..@..@.@..@.@@.....................@@...............@@..@.@....@..@..@.@..@.@@..............@.@....@..@..@.@..@.@@..................
.@.......@..........@.@@........@..@@.....@@@......@.....@.......@.......@..........@.@@........@..@.@.......@..........@.@@........@..@@...
...@..@...@..@...@..@.....@..............@.@.@....@..@....@........@..@...@..@...@..@.....@............@..@...@..@...@..@.....@.............
........@@............@.....@........@@.................................@@............@.....@...............@@............@.....@........@@.
..@....@..............@...................@.....@.....@@..........@....@..............@...............@....@..............@.................
....@.@.......@..@.@...........@.......................@.....@@.....@.@.......@..@.@...........@........@.@.......@..@.@...........@........
.@.....@@...........@@.@.@.@.@.@@...@..@.@.......@@.........@....@.....@@...........@@.@.@.@.@.@@....@.....@@...........@@.@.@.@.@.@@...@..@
...@...@.@@....@.........@@...@.....@...................@..@@......@...@.@@....@.........@@...@........@...@.@@....@.........@@...@.....@...
@.@@.@....@.......@.............@..@....@...............@.......@.@@.@....@.......@.............@..@@.@@.@....@.......@.............@..@....
.....@................@@....@.@.......@@........@..@....@.....@......@................@@....@.@..........@................@@....@.@.......@@
..@@......@.@.@.....@...@@..@.@.....@......................@...@..@@......@.@.@.....@...@@..@.@.......@@......@.@.@.....@...@@..@.@.....@...
@@....@...@................@.............@.......@...@...@..@..@@@....@...@................@........@@....@...@................@............
...................@.@.........@@.....@.....@.....@....@.....@.....................@.@.........@@......................@.@.........@@.....@.
@.@@....@.@..@.@..@..@..........@......@.@..@..@...@..@.........@.@@....@.@..@.@..@..@..........@...@.@@....@.@..@.@..@..@..........@......@
@.....@................@.@.@.....@@.@...@..@.....@..@...........@.....@................@.@.@.....@@.@.....@................@.@.@.....@@.@...
.............@..@@...@..@...@@@@.....@..@.......@...@....@@....@.............@..@@...@..@...@@@@.................@..@@...@..@...@@@@.....@..
@.@.......@...@..@...........@............@....@..@..@.@........@.@.......@...@..@...........@......@.@.......@...@..@...........@..........
......@..@...@@@.@..@....@..@....@...............@..........@@........@..@...@@@.@..@....@..@....@........@..@...@@@.@..@....@..@....@......
..@.....@@..@.................@.........@...@...@.@.@.@...........@.....@@..@.................@.......@.....@@..@.................@.........
...@.@........@..........@@..@.....@@......@...@...@...............@.@........@..........@@..@.....@...@.@........@..........@@..@.....@@...
...............@@....@.@...@............@...@.....@.....@@@....@...............@@....@.@...@.......................@@....@.@...@............
..@....@..@................@.......@@@......@........@.......@@@..@....@..@................@.......@..@....@..@................@.......@@@..
.....@@..@.@....@.............@.@...@......@.....@@.@................@@..@.@....@.............@.@........@@..@.@....@.............@.@...@...
..@......@....@..@.@.@...@@...@....@...........@@@..@..@..@....@..@......@....@..@.@.@...@@...@....@..@......@....@..@.@.@...@@...@....@....
...@@@.@.....@.@....@...@@...@...............@.@....@....@.....@...@@@.@.....@.@....@...@@...@.........@@@.@.....@.@....@...@@...@..........
@@.@...@.....@.....@.....@.............@@@..@...@......@........@@.@...@.....@.....@.....@..........@@.@...@.....@.....@.....@.............@
..........@...@@........@...@...@....@.........@.........@................@...@@........@...@...@.............@...@@........@...@...@....@..
....@.......@..@..............@.........................@...@@......@.......@..@..............@.........@.......@..@..............@.........
........@.@@..@............@@.@@@...@....@..@..@.@@.@..@@.@..@.@........@.@@..@............@@.@@@...........@.@@..@............@@.@@@...@...
.@..@@@...........@..............@...@..........@@@@......@..@...@..@@@...........@..............@...@..@@@...........@..............@...@..
.@....@...@.....@@.....@....@...@....@.........@..@@@.....@@...@.@....@...@.....@@.....@....@...@....@....@...@.....@@.....@....@...@....@..
.......@...........@...@...........@@..................................@...........@...@...........@.......@...........@...@...........@@...
.......@@....@....@..@..@..@@.....@.@.......@......@..@@@@....@........@@....@....@..@..@..@@.....@........@@....@....@..@..@..@@.....@.@...
.......@.........@.@..@.@........@............@........@...@...........@.........@.@..@.@........@.........@.........@.@..@.@........@......
...@.............@.............@....@.@......@...@.............@...@.............@.............@.......@.............@.............@....@.@.
..............@@..@@......@..@..................@....@..@....@................@@..@@......@..@....................@@..@@......@..@..........
@.@....@..@..@.@..@.@@.....................@@...............@@..@.@....@..@..@.@..@.@@..............@.@....@..@..@.@..@.@@..................
.@.......@..........@.@@........@..@@.....@@@......@.....@.......@.......@..........@.@@........@..@.@.......@..........@.@@........@..@@...
...@..@...@..@...@..@.....@..............@.@.@....@..@....@........@..@...@..@...@..@.....@............@..@...@..@...@..@.....@.............
........@@............@.....@........@@.................................@@............@.....@...............@@............@.....@........@@.
..@....@..............@...................@.....@.....@@..........@....@..............@...............@....@..............@.................
....@.@.......@..@.@...........@.......................@.....@@.....@.@.......@..@.@...........@........@.@.......@..@.@...........@........
.@.....@@...........@@.@.@.@.@.@@...@..@.@.......@@.........@....@.....@@...........@@.@.@.@.@.@@....@.....@@...........@@.@.@.@.@.@@...@..@
...@...@.@@....@.........@@...@.....@...................@..@@......@...@.@@....@.........@@...@........@...@.@@....@.........@@...@.....@...
@.@@.@....@.......@.............@..@....@...............@.......@.@@.@....@.......@.............@..@@.@@.@....@.......@.............@..@....
.....@................@@....@.@.......@@........@..@....@.....@......@................@@....@.@..........@................@@....@.@.......@@
..@@......@.@.@.....@...@@..@.@.....@......................@...@..@@......@.@.@.....@...@@..@.@.......@@......@.@.@.....@...@@..@.@.....@...
@@....@...@................@.............@.......@...@...@..@..@@@....@...@................@........@@....@...@................@............
...................@.@.........@@.....@.....@.....@....@.....@.....................@.@.........@@......................@.@.........@@.....@.
@.@@....@.@..@.@..@..@..........@......@.@..@..@...@..@.........@.@@....@.@..@.@..@..@..........@...@.@@....@.@..@.@..@..@..........@......@
@.....@................@.@.@.....@@.@...@..@.....@..@...........@.....@................@.@.@.....@@.@.....@................@.@.@.....@@.@...
.............@..@@...@..@...@@@@.....@..@.......@...@....@@....@.............@..@@...@..@...@@@@.................@..@@...@..@...@@@@.....@..
@.@.......@...@..@...........@..@.........@....@..@..@.@........@.@.......@...@..@...........@..@...@.@.......@...@..@...........@..@.......
@@@@..@..@...............@......@..........@...@...@.@..@..@@..@@@@@..@..@...............@......@...@@@@..@..@...............@......@.......
@@....@...............@.....@..@..@@......@@...............@@...@@....@...............@.....@..@..@@@@....@...............@.....@..@..@@....
@......@.@@.@..@@.@@@...@.......@......@.........@.........@....@......@.@@.@..@@.@@@...@.......@...@......@.@@.@..@@.@@@...@.......@......@
.........@@@........@@...........@.....@....@.@.@....@.@...@.............@@@........@@...........@...........@@@........@@...........@.....@
