type octile
height 170
width 170
map
......@..@...@@@.@..@....@..@....@...............@..........@@........@..@...@@@.@..@....@..@....@........@..@...@@@.@..@....@..@....@...............@..........@@........
..@.....@@..@.................@.........@...@...@.@.@.@...........@.....@@..@.................@.......@.....@@..@.................@.........@...@...@.@.@.@...........@...
...@.@........@..........@@..@.....@@......@...@...@...............@.@........@..........@@..@.....@...@.@........@..........@@..@.....@@......@...@...@...............@.@
...............@@....@.@...@............@...@.....@.....@@@....@...............@@....@.@...@.......................@@....@.@...@............@...@.....@.....@@@....@......
..@....@..@................@.......@@@......@........@.......@@@..@....@..@................@.......@..@....@..@................@.......@@@......@........@.......@@@..@...
.....@@..@.@....@.............@.@...@......@.....@@.@................@@..@.@....@.............@.@........@@..@.@....@.............@.@...@......@.....@@.@................@
..@......@....@..@.@.@...@@...@....@...........@@@..@..@..@....@..@......@....@..@.@.@...@@...@....@..@......@....@..@.@.@...@@...@....@...........@@@..@..@..@....@..@...
...@@@.@.....@.@....@...@@...@...............@.@....@....@.....@...@@@.@.....@.@....@...@@...@.........@@@.@.....@.@....@...@@...@...............@.@....@....@.....@...@@@
@@.@...@.....@.....@.....@.............@@@..@...@......@........@@.@...@.....@.....@.....@..........@@.@...@.....@.....@.....@.............@@@..@...@......@........@@.@..
..........@...@@........@...@...@....@.........@.........@................@...@@........@...@...@.............@...@@........@...@...@....@.........@.........@............
....@.......@..@..............@.........................@...@@......@.......@..@..............@.........@.......@..@..............@.........................@...@@......@.
........@.@@..@............@@.@@@...@....@..@..@.@@.@..@@.@..@.@........@.@@..@............@@.@@@...........@.@@..@............@@.@@@...@....@..@..@.@@.@..@@.@..@.@......
.@..@@@...........@..............@...@..........@@@@......@..@...@..@@@...........@..............@...@..@@@...........@..............@...@..........@@@@......@..@...@..@@
.@....@...@.....@@.....@....@...@....@.........@..@@@.....@@...@.@....@...@.....@@.....@....@...@....@....@...@.....@@.....@....@...@....@.........@..@@@.....@@...@.@....
.......@...........@...@...........@@..................................@...........@...@...........@.......@...........@...@...........@@.................................
.......@@....@....@..@..@..@@.....@.@.......@......@..@@@@....@........@@....@....@..@..@..@@.....@........@@....@....@..@..@..@@.....@.@.......@......@..@@@@....@.......
.......@.........@.@..@.@........@............@........@...@...........@.........@.@..@.@........@.........@.........@.@..@.@........@............@........@...@..........
...@.............@.............@....@.@......@...@.............@...@.............@.............@.......@.............@.............@....@.@......@...@.............@...@..
..............@@..@@......@..@..................@....@..@....@................@@..@@......@..@....................@@..@@......@..@..................@....@..@....@........
@.@....@..@..@.@..@.@@.....................@@...............@@..@.@....@..@..@.@..@.@@..............@.@....@..@..@.@..@.@@.....................@@...............@@..@.@...
.@.......@..........@.@@........@..@@.....@@@......@.....@.......@.......@..........@.@@........@..@.@.......@..........@.@@........@..@@.....@@@......@.....@.......@....
...@..@...@..@...@..@.....@..............@.@.@....@..@....@........@..@...@..@...@..@.....@............@..@...@..@...@..@.....@..............@.@.@....@..@....@........@..
........@@............@.....@........@@.................................@@............@.....@...............@@............@.....@........@@...............................
..@....@..............@...................@.....@.....@@..........@....@..............@...............@....@..............@...................@.....@.....@@..........@...
....@.@.......@..@.@...........@.......................@.....@@.....@.@.......@..@.@...........@........@.@.......@..@.@...........@.......................@.....@@.....@.
.@.....@@...........@@.@.@.@.@.@@...@..@.@.......@@.........@....@.....@@...........@@.@.@.@.@.@@....@.....@@...........@@.@.@.@.@.@@...@..@.@.......@@.........@....@....
...@...@.@@....@.........@@...@.....@...................@..@@......@...@.@@....@.........@@...@........@...@.@@....@.........@@...@.....@...................@..@@......@..
@.@@.@....@.......@.............@..@....@...............@.......@.@@.@....@.......@.............@..@@.@@.@....@.......@.............@..@....@...............@.......@.@@.@
.....@................@@....@.@.......@@........@..@....@.....@......@................@@....@.@..........@................@@....@.@.......@@........@..@....@.....@......@
..@@......@.@.@.....@...@@..@.@.....@......................@...@..@@......@.@.@.....@...@@..@.@.......@@......@.@.@.....@...@@..@.@.....@......................@...@..@@..
@@....@...@................@.............@.......@...@...@..@..@@@....@...@................@........@@....@...@................@.............@.......@...@...@..@..@@@....
...................@.@.........@@.....@.....@.....@....@.....@.....................@.@.........@@......................@.@.........@@.....@.....@.....@....@.....@........
@.@@....@.@..@.@..@..@..........@......@.@..@..@...@..@.........@.@@....@.@..@.@..@..@..........@...@.@@....@.@..@.@..@..@..........@......@.@..@..@...@..@.........@.@@..
@.....@................@.@.@.....@@.@...@..@.....@..@...........@.....@................@.@.@.....@@.@.....@................@.@.@.....@@.@...@..@.....@..@...........@.....
.............@..@@...@..@...@@@@.....@..@.......@...@....@@....@.............@..@@...@..@...@@@@.................@..@@...@..@...@@@@.....@..@.......@...@....@@....@......
@.@.......@...@..@...........@..@.........@....@..@..@.@........@.@.......@...@..@...........@..@...@.@.......@...@..@...........@..@.........@....@..@..@.@........@.@...
@@@@..@..@...............@......@..........@...@...@.@..@..@@..@@@@@..@..@...............@......@...@@@@..@..@...............@......@..........@...@...@.@..@..@@..@@@@@..
@@....@...............@.....@..@..@@......@@...............@@...@@....@...............@.....@..@..@@@@....@...............@.....@..@..@@......@@...............@@...@@....
@......@.@@.@..@@.@@@...@.......@......@.........@....@....@....@......@.@@.@..@@.@@@...@.......@...@......@.@@.@..@@.@@@...@.......@......@.........@....@....@....@.....
.........@@@........@@...........@.....@....@.@.@....@.@...@.............@@@........@@...........@...........@@@........@@...........@.....@....@.@.@....@.@...@..........
................@.@..@@.....@...@.@.@..@........@...@..........@................@.@..@@.....@...@.@.................@.@..@@.....@...@.@.@..@........@...@..........@......
...@..@..@.........@@.....@....@.........@..@...@@@...........@@...@..@..@.........@@.....@....@.......@..@..@.........@@.....@....@.........@..@...@@@...........@@...@..
..@.....@...@............@..@......@....@......@.....@@@....@.@@..@.....@...@............@..@......@..@.....@...@............@..@......@....@......@.....@@@....@.@@..@...
........@.....@@....@.....@.@.....@.....@.@..@..............@..@........@.....@@....@.....@.@.....@@........@.....@@....@.....@.@.....@.....@.@..@..............@..@......
...@.........@....@................@.@@...........@.....@...@......@.........@....@................@...@.........@....@................@.@@...........@.....@...@......@..
..@@@......@@..........@@.................@..@...@@..@.......@....@@@......@@..........@@.............@@@......@@..........@@.................@..@...@@..@.......@....@@@.
@..@........@..@.@...@....@.......@......@...@...........@......@..@........@..@.@...@....@.......@.@..@........@..@.@...@....@.......@......@...@...........@......@..@..
.....@.@.......@.@@......@.....@..@...@......@@@.....@.......@@......@.@.......@.@@......@.....@..@......@.@.......@.@@......@.....@..@...@......@@@.....@.......@@......@
..@....@...@@....@.@.@@@........@...@.@.......@.....@.....@.......@....@...@@....@.@.@@@........@.....@....@...@@....@.@.@@@........@...@.@.......@.....@.....@.......@...
.............@@.....@@...@.......@@.@....@.@.....@@.@@.......@...............@@.....@@...@.......@@..............@@.....@@...@.......@@.@....@.@.....@@.@@.......@........
..@.......@......@......@...........@@.@..........@.@@..@..@......@.......@......@......@.............@.......@......@......@...........@@.@..........@.@@..@..@......@...
.....@....@@..@...@...@.......@......@....@..@@....@...@.@...........@....@@..@...@...@.......@..........@....@@..@...@...@.......@......@....@..@@....@...@.@...........@
..@.......@..@.............@.@@......@@.@...@.........@........@..@.......@..@.............@.@@.......@.......@..@.............@.@@......@@.@...@.........@........@..@...
@@...@....@.@..@.@..@..@..@.@.@...@@@...@.@......@..@....@....@.@@...@....@.@..@.@..@..@..@.@.@...@@@@...@....@.@..@.@..@..@..@.@.@...@@@...@.@......@..@....@....@.@@...@
.....@.......@.......@..@..........@@@............@.....@.@.@........@.......@.......@..@..........@.....@.......@.......@..@..........@@@............@.....@.@.@........@
...@....@......@.@...@..@..@.....@@@@@...@.....@..@.@..@...@.......@....@......@.@...@..@..@.....@@@...@....@......@.@...@..@..@.....@@@@@...@.....@..@.@..@...@.......@..
.....@.....@...@...@@...@...@@..@...@..............@...@...@.@@......@.....@...@...@@...@...@@..@........@.....@...@...@@...@...@@..@...@..............@...@...@.@@......@
.......@....@.@@...@@.@@........@....@.@.@@@..@....@....@@..@..........@....@.@@...@@.@@........@..........@....@.@@...@@.@@........@....@.@.@@@..@....@....@@..@.........
......@....@@....@@.@.@....@.@.@..@.@......@...@.....@@...............@....@@....@@.@.@....@.@.@..@.......@....@@....@@.@.@....@.@.@..@.@......@...@.....@@...............
.......@@..@...........@....@....@......@..@..@...@.@.@@@......@.......@@..@...........@....@....@.........@@..@...........@....@....@......@..@..@...@.@.@@@......@......
.@.........@....@..@.....@.........@@..@.....@.....@...@..@......@.........@....@..@.....@.........@.@.........@....@..@.....@.........@@..@.....@.....@...@..@......@....
@.@...@...@...@...@@@@@.@..@@....................@.@@...@....@..@.@...@...@...@...@@@@@.@..@@.......@.@...@...@...@...@@@@@.@..@@....................@.@@...@....@..@.@...
@..........@@.....@..@...@........@@.@.@....@..@@...............@..........@@.....@..@...@........@@@..........@@.....@..@...@........@@.@.@....@..@@...............@.....
@.@....@...............@........@..@.@@@.............@@.@.......@.@....@...............@........@..@@.@....@...............@........@..@.@@@.............@@.@.......@.@...
......@..@...@@@.@..@....@..@....@...............@..........@@........@..@...@@@.@..@....@..@....@........@..@...@@@.@..@....@..@....@...............@..........@@........
..@.....@@..@.................@.........@...@...@.@.@.@...........@.....@@..@.................@.......@.....@@..@.................@.........@...@...@.@.@.@...........@...
...@.@........@..........@@..@.....@@......@...@...@...............@.@........@..........@@..@.....@...@.@........@..........@@..@.....@@......@...@...@...............@.@
...............@@....@.@...@............@...@.....@.....@@@....@...............@@....@.@...@.......................@@....@.@...@............@...@.....@.....@@@....@......
..@....@..@................@.......@@@......@........@.......@@@..@....@..@................@.......@..@....@..@................@.......@@@......@........@.......@@@..@...
.....@@..@.@....@.............@.@...@......@.....@@.@................@@..@.@....@.............@.@........@@..@.@....@.............@.@...@......@.....@@.@................@
..@......@....@..@.@.@...@@...@....@...........@@@..@..@..@....@..@......@....@..@.@.@...@@...@....@..@......@....@..@.@.@...@@...@....@...........@@@..@..@..@....@..@...
...@@@.@.....@.@....@...@@...@...............@.@....@....@.....@...@@@.@.....@.@....@...@@...@.........@@@.@.....@.@....@...@@...@...............@.@....@....@.....@...@@@
@@.@...@.....@.....@.....@.............@@@..@...@......@........@@.@...@.....@.....@.....@..........@@.@...@.....@.....@.....@.............@@@..@...@......@........@@.@..
..........@...@@........@...@...@....@.........@.........@................@...@@........@...@...@.............@...@@........@...@...@....@.........@.........@............
....@.......@..@..............@.........................@...@@......@.......@..@..............@.........@.......@..@..............@.........................@...@@......@.
........@.@@..@............@@.@@@...@....@..@..@.@@.@..@@.@..@.@........@.@@..@............@@.@@@...........@.@@..@............@@.@@@...@....@..@..@.@@.@..@@.@..@.@......
.@..@@@...........@..............@...@..........@@@@......@..@...@..@@@...........@..............@...@..@@@...........@..............@...@..........@@@@......@..@...@..@@
.@....@...@.....@@.....@....@...@....@.........@..@@@.....@@...@.@....@...@.....@@.....@....@...@....@....@...@.....@@.....@....@...@....@.........@..@@@.....@@...@.@....
.......@...........@...@...........@@..................................@...........@...@...........@.......@...........@...@...........@@.................................
.......@@....@....@..@..@..@@.....@.@.......@......@..@@@@....@........@@....@....@..@..@..@@.....@........@@....@....@..@..@..@@.....@.@.......@......@..@@@@....@.......
.......@.........@.@..@.@........@............@........@...@...........@.........@.@..@.@........@.........@.........@.@..@.@........@............@........@...@..........
...@.............@.............@....@.@......@...@.............@...@.............@.............@.......@.............@.............@....@.@......@...@.............@...@..
..............@@..@@......@..@..................@....@..@....@................@@..@@......@..@....................@@..@@......@..@..................@....@..@....@........
@.@....@..@..@.@..@.@@.....................@@...............@@..@.@....@..@..@.@..@.@@..............@.@....@..@..@.@..@.@@.....................@@...............@@..@.@...
.@.......@..........@.@@........@..@@.....@@@......@.....@.......@.......@..........@.@@........@..@.@.......@..........@.@@........@..@@.....@@@......@.....@.......@....
...@..@...@..@...@..@.....@..............@.@.@....@..@....@........@..@...@..@...@..@.....@............@..@...@..@...@..@.....@..............@.@.@....@..@....@........@..
........@@............@.....@........@@.................................@@............@.....@...............@@............@.....@........@@...............................
..@....@..............@...................@.....@.....@@..........@....@..............@...............@....@..............@...................@.....@.....@@..........@...
....@.@.......@..@.@...........@.......................@.....@@.....@.@.......@..@.@...........@........@.@.......@..@.@...........@.......................@.....@@.....@.
.@.....@@...........@@.@.@.@.@.@@...@..@.@.......@@.........@....@.....@@...........@@.@.@.@.@.@@....@.....@@...........@@.@.@.@.@.@@...@..@.@.......@@.........@....@....
...@...@.@@....@.........@@...@.....@...................@..@@......@...@.@@....@.........@@...@........@...@.@@....@.........@@...@.....@...................@..@@......@..
@.@@.@....@.......@.............@..@....@...............@.......@.@@.@....@.......@.............@..@@.@@.@....@.......@.............@..@....@...............@.......@.@@.@
.....@................@@....@.@.......@@........@..@....@.....@......@................@@....@.@..........@................@@....@.@.......@@........@..@....@.....@......@
..@@......@.@.@.....@...@@..@.@.....@......................@...@..@@......@.@.@.....@...@@..@.@.......@@......@.@.@.....@...@@..@.@.....@......................@...@..@@..
@@....@...@................@.............@.......@...@...@..@..@@@....@...@................@........@@....@...@................@.............@.......@...@...@..@..@@@....
...................@.@.........@@.....@.....@.....@....@.....@.....................@.@.........@@......................@.@.........@@.....@.....@.....@....@.....@........
@.@@....@.@..@.@..@..@..........@......@.@..@..@...@..@.........@.@@....@.@..@.@..@..@..........@...@.@@....@.@..@.@..@..@..........@......@.@..@..@...@..@.........@.@@..
@.....@................@.@.@.....@@.@...@..@.....@..@...........@.....@................@.@.@.....@@.@.....@................@.@.@.....@@.@...@..@.....@..@...........@.....
.............@..@@...@..@...@@@@.....@..@.......@...@....@@....@.............@..@@...@..@...@@@@.................@..@@...@..@...@@@@.....@..@.......@...@....@@....@......
@.@.......@...@..@...........@............@....@..@..@.@........@.@.......@...@..@...........@......@.@.......@...@..@...........@............@....@..@..@.@........@.@...
......@..@...@@@.@..@....@..@....@...............@..........@@........@..@...@@@.@..@....@..@....@........@..@...@@@.@..@....@..@....@...............@..........@@........
..@.....@@..@.................@.........@...@...@.@.@.@...........@.....@@..@.................@.......@.....@@..@.................@.........@...@...@.@.@.@...........@...
...@.@........@..........@@..@.....@@......@...@...@...............@.@........@..........@@..@.....@...@.@........@..........@@..@.....@@......@...@...@...............@.@
...............@@....@.@...@............@...@.....@.....@@@....@...............@@....@.@...@.......................@@....@.@...@............@...@.....@.....@@@....@......
..@....@..@................@.......@@@......@........@.......@@@..@....@..@................@.......@..@....@..@................@.......@@@......@........@.......@@@..@...
.....@@..@.@....@.............@.@...@......@.....@@.@................@@..@.@....@.............@.@........@@..@.@....@.............@.@...@......@.....@@.@................@
..@......@....@..@.@.@...@@...@....@...........@@@..@..@..@....@..@......@....@..@.@.@...@@...@....@..@......@....@..@.@.@...@@...@....@...........@@@..@..@..@....@..@...
...@@@.@.....@.@....@...@@...@...............@.@....@....@.....@...@@@.@.....@.@....@...@@...@.........@@@.@.....@.@....@...@@...@...............@.@....@....@.....@...@@@
@@.@...@.....@.....@.....@.............@@@..@...@......@........@@.@...@.....@.....@.....@..........@@.@...@.....@.....@.....@.............@@@..@...@......@........@@.@..
..........@...@@........@...@...@....@.........@.........@................@...@@........@...@...@.............@...@@........@...@...@....@.........@.........@............
....@.......@..@..............@.........................@...@@......@.......@..@..............@.........@.......@..@..............@.........................@...@@......@.
........@.@@..@............@@.@@@...@....@..@..@.@@.@..@@.@..@.@........@.@@..@............@@.@@@...........@.@@..@............@@.@@@...@....@..@..@.@@.@..@@.@..@.@......
.@..@@@...........@..............@...@..........@@@@......@..@...@..@@@...........@..............@...@..@@@...........@..............@...@..........@@@@......@..@...@..@@
.@....@...@.....@@.....@....@...@....@.........@..@@@.....@@...@.@....@...@.....@@.....@....@...@....@....@...@.....@@.....@....@...@....@.........@..@@@.....@@...@.@....
.......@...........@...@...........@@..................................@...........@...@...........@.......@...........@...@...........@@.................................
.......@@....@....@..@..@..@@.....@.@.......@......@..@@@@....@........@@....@....@..@..@..@@.....@........@@....@....@..@..@..@@.....@.@.......@......@..@@@@....@.......
.......@.........@.@..@.@........@............@........@...@...........@.........@.@..@.@........@.........@.........@.@..@.@........@............@........@...@..........
...@.............@.............@....@.@......@...@.............@...@.............@.............@.......@.............@.............@....@.@......@...@.............@...@..
..............@@..@@......@..@..................@....@..@....@................@@..@@......@..@....................@@..@@......@..@..................@....@..@....@........
@.@....@..@..@.@..@.@@.....................@@...............@@..@.@....@..@..@.@..@.@@..............@.@....@..@..@.@..@.@@.....................@@...............@@..@.@...
.@.......@..........@.@@........@..@@.....@@@......@.....@.......@.......@..........@.@@........@..@.@.......@..........@.@@........@..@@.....@@@......@.....@.......@....
...@..@...@..@...@..@.....@..............@.@.@....@..@....@........@..@...@..@...@..@.....@............@..@...@..@...@..@.....@..............@.@.@....@..@....@........@..
........@@............@.....@........@@.................................@@............@.....@...............@@............@.....@........@@...............................
..@....@..............@...................@.....@.....@@..........@....@..............@...............@....@..............@...................@.....@.....@@..........@...
....@.@.......@..@.@...........@.......................@.....@@.....@.@.......@..@.@...........@........@.@.......@..@.@...........@.......................@.....@@.....@.
.@.....@@...........@@.@.@.@.@.@@...@..@.@.......@@.........@....@.....@@...........@@.@.@.@.@.@@....@.....@@...........@@.@.@.@.@.@@...@..@.@.......@@.........@....@....
...@...@.@@....@.........@@...@.....@...................@..@@......@...@.@@....@.........@@...@........@...@.@@....@.........@@...@.....@...................@..@@......@..
@.@@.@....@.......@.............@..@....@...............@.......@.@@.@....@.......@.............@..@@.@@.@....@.......@.............@..@....@...............@.......@.@@.@
.....@................@@....@.@.......@@........@..@....@.....@......@................@@....@.@..........@................@@....@.@.......@@........@..@....@.....@......@
..@@......@.@.@.....@...@@..@.@.....@......................@...@..@@......@.@.@.....@...@@..@.@.......@@......@.@.@.....@...@@..@.@.....@......................@...@..@@..
@@....@...@................@.............@.......@...@...@..@..@@@....@...@................@........@@....@...@................@.............@.......@...@...@..@..@@@....
...................@.@.........@@.....@.....@.....@....@.....@.....................@.@.........@@......................@.@.........@@.....@.....@.....@....@.....@........
@.@@....@.@..@.@..@..@..........@......@.@..@..@...@..@.........@.@@....@.@..@.@..@..@..........@...@.@@....@.@..@.@..@..@..........@......@.@..@..@...@..@.........@.@@..
@.....@................@.@.@.....@@.@...@..@.....@..@...........@.....@................@.@.@.....@@.@.....@................@.@.@.....@@.@...@..@.....@..@...........@.....
.............@..@@...@..@...@@@@.....@..@.......@...@....@@....@.............@..@@...@..@...@@@@.................@..@@...@..@...@@@@.....@..@.......@...@....@@....@......
@.@.......@...@..@...........@..@.........@....@..@..@.@........@.@.......@...@..@...........@..@...@.@.......@...@..@...........@..@.........@....@..@..@.@........@.@...
@@@@..@..@...............@......@..........@...@...@.@..@..@@..@@@@@..@..@...............@......@...@@@@..@..@...............@......@..........@...@...@.@..@..@@..@@@@@..
@@....@...............@.....@..@..@@......@@...............@@...@@....@...............@.....@..@..@@@@....@...............@.....@..@..@@......@@...............@@...@@....
@......@.@@.@..@@.@@@...@.......@......@.........@....@....@....@......@.@@.@..@@.@@@...@.......@...@......@.@@.@..@@.@@@...@.......@......@.........@....@....@....@.....
.........@@@........@@...........@.....@....@.@.@....@.@...@.............@@@........@@...........@...........@@@........@@...........@.....@....@.@.@....@.@...@..........
................@.@..@@.....@...@.@.@..@........@...@..........@................@.@..@@.....@...@.@.................@.@..@@.....@...@.@.@..@........@...@..........@......
...@..@..@.........@@.....@....@.........@..@...@@@...........@@...@..@..@.........@@.....@....@.......@..@..@.........@@.....@....@.........@..@...@@@...........@@...@..
..@.....@...@............@..@......@....@......@.....@@@....@.@@..@.....@...@............@..@......@..@.....@...@............@..@......@....@......@.....@@@....@.@@..@...
........@.....@@....@.....@.@.....@.....@.@..@..............@..@........@.....@@....@.....@.@.....@@........@.....@@....@.....@.@.....@.....@.@..@..............@..@......
...@.........@....@................@.@@...........@.....@...@......@.........@....@................@...@.........@....@................@.@@...........@.....@...@......@..
..@@@......@@..........@@.................@..@...@@..@.......@....@@@......@@..........@@.............@@@......@@..........@@.................@..@...@@..@.......@....@@@.
@..@........@..@.@...@....@.......@......@...@...........@......@..@........@..@.@...@....@.......@.@..@........@..@.@...@....@.......@......@...@...........@......@..@..
.....@.@.......@.@@......@.....@..@...@......@@@.....@.......@@......@.@.......@.@@......@.....@..@......@.@.......@.@@......@.....@..@...@......@@@.....@.......@@......@
..@....@...@@....@.@.@@@........@...@.@.......@.....@.....@.......@....@...@@....@.@.@@@........@.....@....@...@@....@.@.@@@........@...@.@.......@.....@.....@.......@...
.............@@.....@@...@.......@@.@....@.@.....@@.@@.......@...............@@.....@@...@.......@@..............@@.....@@...@.......@@.@....@.@.....@@.@@.......@........
..@.......@......@......@...........@@.@..........@.@@..@..@......@.......@......@......@.............@.......@......@......@...........@@.@..........@.@@..@..@......@...
.....@....@@..@...@...@.......@......@....@..@@....@...@.@...........@....@@..@...@...@.......@..........@....@@..@...@...@.......@......@....@..@@....@...@.@...........@
..@.......@..@.............@.@@......@@.@...@.........@........@..@.......@..@.............@.@@.......@.......@..@.............@.@@......@@.@...@.........@........@..@...
@@...@....@.@..@.@..@..@..@.@.@...@@@...@.@......@..@....@....@.@@...@....@.@..@.@..@..@..@.@.@...@@@@...@....@.@..@.@..@..@..@.@.@...@@@...@.@......@..@....@....@.@@...@
.....@.......@.......@..@..........@@@............@.....@.@.@........@.......@.......@..@..........@.....@.......@.......@..@..........@@@............@.....@.@.@........@
...@....@......@.@...@..@..@.....@@@@@...@.....@..@.@..@...@.......@....@......@.@...@..@..@.....@@@...@....@......@.@...@..@..@.....@@@@@...@.....@..@.@..@...@.......@..
.....@.....@...@...@@...@...@@..@...@..............@...@...@.@@......@.....@...@...@@...@...@@..@........@.....@...@...@@...@...@@..@...@..............@...@...@.@@......@
.......@....@.@@...@@.@@........@....@.@.@@@..@....@....@@..@..........@....@.@@...@@.@@........@..........@....@.@@...@@.@@........@....@.@.@@@..@....@....@@..@.........
......@....@@....@@.@.@....@.@.@..@.@......@...@.....@@...............@....@@....@@.@.@....@.@.@..@.......@....@@....@@.@.@....@.@.@..@.@......@...@.....@@...............
.......@@..@...........@....@....@......@..@..@...@.@.@@@......@.......@@..@...........@....@....@.........@@..@...........@....@....@......@..@..@...@.@.@@@......@......
.@.........@....@..@.....@.........@@..@.....@.....@...@..@......@.........@....@..@.....@.........@.@.........@....@..@.....@.........@@..@.....@.....@...@..@......@....
@.@...@...@...@...@@@@@.@..@@....................@.@@...@....@..@.@...@...@...@...@@@@@.@..@@.......@.@...@...@...@...@@@@@.@..@@....................@.@@...@....@..@.@...
@..........@@.....@..@...@........@@.@.@....@..@@...............@..........@@.....@..@...@........@@@..........@@.....@..@...@........@@.@.@....@..@@...............@.....
@.@....@...............@........@..@.@@@.............@@.@.......@.@....@...............@........@..@@.@....@...............@........@..@.@@@.............@@.@.......@.@...
......@..@...@@@.@..@....@..@....@...............@..........@@........@..@...@@@.@..@....@..@....@........@..@...@@@.@..@....@..@....@...............@..........@@........
..@.....@@..@.................@.........@...@...@.@.@.@...........@.....@@..@.................@.......@.....@@..@.................@.........@...@...@.@.@.@...........@...
...@.@........@..........@@..@.....@@......@...@...@...............@.@........@..........@@..@.....@...@.@........@..........@@..@.....@@......@...@...@...............@.@
...............@@....@.@...@............@...@.....@.....@@@....@...............@@....@.@...@.......................@@....@.@...@............@...@.....@.....@@@....@......
..@....@...................@.......@@@......@........@.......@@@..@....@..@................@.......@..@....@...................@.......@@@......@........@.......@@@..@...
.....@@..@.@....@.............@.@...@......@.....@@.@................@@..@.@....@.............@.@........@@..@.@....@.............@.@...@......@.....@@.@................@
