type octile
height 150
width 150
map
......@..@...@@@.@..@....@..@....@...............@..........@@........@..@...@@@.@..@....@..@....@........@..@...@@@.@..@....@..@....@...............@
..@.....@@..@.................@.........@...@...@.@.@.@...........@.....@@..@.................@.......@.....@@..@.................@.........@...@...@.
...@.@........@..........@@..@.....@@......@...@...@...............@.@........@..........@@..@.....@...@.@........@..........@@..@.....@@......@...@..
...............@@....@.@...@............@...@.....@.....@@@....@...............@@....@.@...@.......................@@....@.@...@............@...@.....
..@....@..@................@.......@@@......@........@.......@@@..@....@..@................@.......@..@....@..@................@.......@@@......@.....
.....@@..@.@....@.............@.@...@......@.....@@.@................@@..@.@....@.............@.@........@@..@.@....@.............@.@...@......@.....@
..@......@....@..@.@.@...@@...@....@...........@@@..@..@..@....@..@......@....@..@.@.@...@@...@....@..@......@....@..@.@.@...@@...@....@...........@@@
...@@@.@.....@.@....@...@@...@...............@.@....@....@.....@...@@@.@.....@.@....@...@@...@.........@@@.@.....@.@....@...@@...@...............@.@..
@@.@...@.....@.....@.....@.............@@@..@...@......@........@@.@...@.....@.....@.....@..........@@.@...@.....@.....@.....@.............@@@..@...@.
..........@...@@........@...@...@....@.........@.........@................@...@@........@...@...@.............@...@@........@...@...@....@.........@..
....@.......@..@..............@.........................@...@@......@.......@..@..............@.........@.......@..@..............@...................
........@.@@..@............@@.@@@...@....@..@..@.@@.@..@@.@..@.@........@.@@..@............@@.@@@...........@.@@..@............@@.@@@...@....@..@..@.@
.@..@@@...........@..............@...@..........@@@@......@..@...@..@@@...........@..............@...@..@@@...........@..............@...@..........@@
.@....@...@.....@@.....@....@...@....@.........@..@@@.....@@...@.@....@...@.....@@.....@....@...@....@....@...@.....@@.....@....@...@....@.........@..
.......@...........@...@...........@@..................................@...........@...@...........@.......@...........@...@...........@@.............
.......@@....@....@..@..@..@@.....@.@.......@......@..@@@@....@........@@....@....@..@..@..@@.....@........@@....@....@..@..@..@@.....@.@.......@.....
.......@.........@.@..@.@........@............@........@...@...........@.........@.@..@.@........@.........@.........@.@..@.@........@............@...
...@.............@.............@....@.@......@...@.............@...@.............@.............@.......@.............@.............@....@.@......@...@
..............@@..@@......@..@..................@....@..@....@................@@..@@......@..@....................@@..@@......@..@..................@.
@.@....@..@..@.@..@.@@.....................@@...............@@..@.@....@..@..@.@..@.@@..............@.@....@..@..@.@..@.@@.....................@@.....
.@.......@..........@.@@........@..@@.....@@@......@.....@.......@.......@..........@.@@........@..@.@.......@..........@.@@........@..@@.....@@@.....
...@..@...@..@...@..@.....@..............@.@.@....@..@....@........@..@...@..@...@..@.....@............@..@...@..@...@..@.....@..............@.@.@....
........@@............@.....@........@@.................................@@............@.....@...............@@............@.....@........@@...........
..@....@..............@...................@.....@.....@@..........@....@..............@...............@....@..............@...................@.....@.
....@.@.......@..@.@...........@.......................@.....@@.....@.@.......@..@.@...........@........@.@.......@..@.@...........@..................
.@.....@@...........@@.@.@.@.@.@@...@..@.@.......@@.........@....@.....@@...........@@.@.@.@.@.@@....@.....@@...........@@.@.@.@.@.@@...@..@.@.......@
...@...@.@@....@.........@@...@.....@...................@..@@......@...@.@@....@.........@@...@........@...@.@@....@.........@@...@.....@.............
@.@@.@....@.......@.............@..@....@...............@.......@.@@.@....@.......@.............@..@@.@@.@....@.......@.............@..@....@.........
.....@................@@....@.@.......@@........@..@....@.....@......@................@@....@.@..........@................@@....@.@.......@@........@.
..@@......@.@.@.....@...@@..@.@.....@......................@...@..@@......@.@.@.....@...@@..@.@.......@@......@.@.@.....@...@@..@.@.....@.............
@@....@...@................@.............@.......@...@...@..@..@@@....@...@................@........@@....@...@................@.............@.......@
...................@.@.........@@.....@.....@.....@....@.....@.....................@.@.........@@......................@.@.........@@.....@.....@.....
@.@@....@.@..@.@..@..@..........@......@.@..@..@...@..@.........@.@@....@.@..@.@..@..@..........@...@.@@....@.@..@.@..@..@..........@......@.@..@..@..
@.....@................@.@.@.....@@.@...@..@.....@..@...........@.....@................@.@.@.....@@.@.....@................@.@.@.....@@.@...@..@.....@
.............@..@@...@..@...@@@@.....@..@.......@...@....@@....@.............@..@@...@..@...@@@@.................@..@@...@..@...@@@@.....@..@.......@.
@.@.......@...@..@...........@..@.........@....@..@..@.@........@.@.......@...@..@...........@..@...@.@.......@...@..@...........@..@.........@....@..
@@@@..@..@...............@......@..........@...@...@.@..@..@@..@@@@@..@..@...............@......@...@@@@..@..@...............@......@..........@...@..
@@....@...............@.....@..@..@@......@@...............@@...@@....@...............@.....@..@..@@@@....@...............@.....@..@..@@......@@......
@......@.@@.@..@@.@@@...@.......@......@.........@....@....@....@......@.@@.@..@@.@@@...@.......@...@......@.@@.@..@@.@@@...@.......@......@.........@
.........@@@........@@...........@.....@....@.@.@....@.@...@.............@@@........@@...........@...........@@@........@@...........@.....@....@.@...
................@.@..@@.....@...@.@.@..@........@...@..........@................@.@..@@.....@...@.@.................@.@..@@.....@...@.@.@..@........@.
...@..@..@.........@@.....@....@.........@..@...@@@...........@@...@..@..@.........@@.....@....@.......@..@..@.........@@.....@....@.........@..@...@@
..@.....@...@............@..@......@....@......@.....@@@....@.@@..@.....@...@............@..@......@..@.....@...@............@..@......@....@......@..
........@.....@@....@.....@.@.....@.....@.@..@..............@..@........@.....@@....@.....@.@.....@@........@.....@@....@.....@.@.....@.....@.@..@....
...@.........@....@................@.@@...........@.....@...@......@.........@....@................@...@.........@....@................@.@@...........
..@@@......@@..........@@.................@..@...@@..@.......@....@@@......@@..........@@.............@@@......@@..........@@.................@..@...@
@..@........@..@.@...@....@.......@......@...@...........@......@..@........@..@.@...@....@.......@.@..@........@..@.@...@....@.......@......@...@....
.....@.@.......@.@@......@.....@..@...@......@@@.....@.......@@......@.@.......@.@@......@.....@..@......@.@.......@.@@......@.....@..@...@......@@@..
..@....@...@@....@.@.@@@........@...@.@.......@.....@.....@.......@....@...@@....@.@.@@@........@.....@....@...@@....@.@.@@@........@...@.@.......@...
.............@@.....@@...@.......@@.@....@.@.....@@.@@.......@...............@@.....@@...@.......@@..............@@.....@@...@.......@@.@....@.@.....@
..@.......@......@......@...........@@.@..........@.@@..@..@......@.......@......@......@.............@.......@......@......@...........@@.@..........
.....@....@@..@...@...@.......@......@....@..@@....@...@.@...........@....@@..@...@...@.......@..........@....@@..@...@...@.......@......@....@..@@...
..@.......@..@.............@.@@......@@.@...@.........@........@..@.......@..@.............@.@@.......@.......@..@.............@.@@......@@.@...@.....
@@...@....@.@..@.@..@..@..@.@.@...@@@...@.@......@..@....@....@.@@...@....@.@..@.@..@..@..@.@.@...@@@@...@....@.@..@.@..@..@..@.@.@...@@@...@.@......@
.....@.......@.......@..@..........@@@............@.....@.@.@........@.......@.......@..@..........@.....@.......@.......@..@..........@@@............
...@....@......@.@...@..@..@.....@@@@@...@.....@..@.@..@...@.......@....@......@.@...@..@..@.....@@@...@....@......@.@...@..@..@.....@@@@@...@.....@..
.....@.....@...@...@@...@...@@..@...@..............@...@...@.@@......@.....@...@...@@...@...@@..@........@.....@...@...@@...@...@@..@...@.............
.......@....@.@@...@@.@@........@....@.@.@@@..@....@....@@..@..........@....@.@@...@@.@@........@..........@....@.@@...@@.@@........@....@.@.@@@..@...
......@....@@....@@.@.@....@.@.@..@.@......@...@.....@@...............@....@@....@@.@.@....@.@.@..@.......@....@@....@@.@.@....@.@.@..@.@......@...@..
.......@@..@...........@....@....@......@..@..@...@.@.@@@......@.......@@..@...........@....@....@.........@@..@...........@....@....@......@..@..@...
.@.........@....@..@.....@.........@@..@.....@.....@...@..@......@.........@....@..@.....@.........@.@.........@....@..@.....@.........@@..@.....@....
@.@...@...@...@...@@@@@.@..@@....................@.@@...@....@..@.@...@...@...@...@@@@@.@..@@.......@.@...@...@...@...@@@@@.@..@@....................@
@..........@@.....@..@...@........@@.@.@....@..@@...............@..........@@.....@..@...@........@@@..........@@.....@..@...@........@@.@.@....@..@@.
@.@....@...............@........@..@.@@@.............@@.@.......@.@....@...............@........@..@@.@....@...............@........@..@.@@@..........
......@..@...@@@.@..@....@..@....@...............@..........@@........@..@...@@@.@..@....@..@....@........@..@...@@@.@..@....@..@....@...............@
..@.....@@..@.................@.........@...@...@.@.@.@...........@.....@@..@.................@.......@.....@@..@.................@.........@...@...@.
...@.@........@..........@@..@.....@@......@...@...@...............@.@........@..........@@..@.....@...@.@........@..........@@..@.....@@......@...@..
...............@@....@.@...@............@...@.....@.....@@@....@...............@@....@.@...@.......................@@....@.@...@............@...@.....
..@....@..@................@.......@@@......@........@.......@@@..@....@..@................@.......@..@....@..@................@.......@@@......@.....
.....@@..@.@....@.............@.@...@......@.....@@.@................@@..@.@....@.............@.@........@@..@.@....@.............@.@...@......@.....@
..@......@....@..@.@.@...@@...@....@...........@@@..@..@..@....@..@......@....@..@.@.@...@@...@....@..@......@....@..@.@.@...@@...@....@...........@@@
...@@@.@.....@.@....@...@@...@...............@.@....@....@.....@...@@@.@.....@.@....@...@@...@.........@@@.@.....@.@....@...@@...@...............@.@..
@@.@...@.....@.....@.....@.............@@@..@...@......@........@@.@...@.....@.....@.....@..........@@.@...@.....@.....@.....@.............@@@..@...@.
..........@...@@........@...@...@....@.........@.........@................@...@@........@...@...@.............@...@@........@...@...@....@.........@..
....@.......@..@..............@.........................@...@@......@.......@..@..............@.........@.......@..@..............@...................
........@.@@..@............@@.@@@...@....@..@..@.@@.@..@@.@..@.@........@.@@..@............@@.@@@...........@.@@..@............@@.@@@...@....@..@..@.@
.@..@@@...........@..............@...@..........@@@@......@..@...@..@@@...........@..............@...@..@@@...........@..............@...@..........@@
.@....@...@.....@@.....@....@...@....@.........@..@@@.....@@...@.@....@...@.....@@.....@....@...@....@....@...@.....@@.....@....@...@....@.........@..
.......@...........@...@...........@@..................................@...........@...@...........@.......@...........@...@...........@@.............
.......@@....@....@..@..@..@@.....@.@.......@......@..@@@@....@........@@....@....@..@..@..@@.....@........@@....@....@..@..@..@@.....@.@.......@.....
.......@.........@.@..@.@........@............@........@...@...........@.........@.@..@.@........@.........@.........@.@..@.@........@............@...
...@.............@.............@....@.@......@...@.............@...@.............@.............@.......@.............@.............@....@.@......@...@
..............@@..@@......@..@..................@....@..@....@................@@..@@......@..@....................@@..@@......@..@..................@.
@.@....@..@..@.@..@.@@.....................@@...............@@..@.@....@..@..@.@..@.@@..............@.@....@..@..@.@..@.@@.....................@@.....
.@.......@..........@.@@........@..@@.....@@@......@.....@.......@.......@..........@.@@........@..@.@.......@..........@.@@........@..@@.....@@@.....
...@..@...@..@...@..@.....@..............@.@.@....@..@....@........@..@...@..@...@..@.....@............@..@...@..@...@..@.....@..............@.@.@....
........@@............@.....@........@@.................................@@............@.....@...............@@............@.....@........@@...........
..@....@..............@...................@.....@.....@@..........@....@..............@...............@....@..............@...................@.....@.
....@.@.......@..@.@...........@.......................@.....@@.....@.@.......@..@.@...........@........@.@.......@..@.@...........@..................
.@.....@@...........@@.@.@.@.@.@@...@..@.@.......@@.........@....@.....@@...........@@.@.@.@.@.@@....@.....@@...........@@.@.@.@.@.@@...@..@.@.......@
...@...@.@@....@.........@@...@.....@...................@..@@......@...@.@@....@.........@@...@........@...@.@@....@.........@@...@.....@.............
@.@@.@....@.......@.............@..@....@...............@.......@.@@.@....@.......@.............@..@@.@@.@....@.......@.............@..@....@.........
.....@................@@....@.@.......@@........@..@....@.....@......@................@@....@.@..........@................@@....@.@.......@@........@.
..@@......@.@.@.....@...@@..@.@.....@......................@...@..@@......@.@.@.....@...@@..@.@.......@@......@.@.@.....@...@@..@.@.....@.............
@@....@...@................@.............@.......@...@...@..@..@@@....@...@................@........@@....@...@................@.............@.......@
...................@.@.........@@.....@.....@.....@....@.....@.....................@.@.........@@......................@.@.........@@.....@.....@.....
@.@@....@.@..@.@..@..@..........@......@.@..@..@...@..@.........@.@@....@.@..@.@..@..@..........@...@.@@....@.@..@.@..@..@..........@......@.@..@..@..
@.....@................@.@.@.....@@.@...@..@.....@..@...........@.....@................@.@.@.....@@.@.....@................@.@.@.....@@.@...@..@.....@
.............@..@@...@..@...@@@@.....@..@.......@...@....@@....@.............@..@@...@..@...@@@@.................@..@@...@..@...@@@@.....@..@.......@.
@.@.......@...@..@...........@............@....@..@..@.@........@.@.......@...@..@...........@......@.@.......@...@..@...........@............@....@..
......@..@...@@@.@..@....@..@....@...............@..........@@........@..@...@@@.@..@....@..@....@........@..@...@@@.@..@....@..@....@...............@
..@.....@@..@.................@.........@...@...@.@.@.@...........@.....@@..@.................@.......@.....@@..@.................@.........@...@...@.
...@.@........@..........@@..@.....@@......@...@...@...............@.@........@..........@@..@.....@...@.@........@..........@@..@.....@@......@...@..
...............@@....@.@...@............@...@.....@.....@@@....@...............@@....@.@...@.......................@@....@.@...@............@...@.....
..@....@..@................@.......@@@......@........@.......@@@..@....@..@................@.......@..@....@..@................@.......@@@......@.....
.....@@..@.@....@.............@.@...@......@.....@@.@................@@..@.@....@.............@.@........@@..@.@....@.............@.@...@......@.....@
..@......@....@..@.@.@...@@...@....@...........@@@..@..@..@....@..@......@....@..@.@.@...@@...@....@..@......@....@..@.@.@...@@...@....@...........@@@
...@@@.@.....@.@....@...@@...@...............@.@....@....@.....@...@@@.@.....@.@....@...@@...@.........@@@.@.....@.@....@...@@...@...............@.@..
@@.@...@.....@.....@.....@.............@@@..@...@......@........@@.@...@.....@.....@.....@..........@@.@...@.....@.....@.....@.............@@@..@...@.
..........@...@@........@...@...@....@.........@.........@................@...@@........@...@...@.............@...@@........@...@...@....@.........@..
....@.......@..@..............@.........................@...@@......@.......@..@..............@.........@.......@..@..............@...................
........@.@@..@............@@.@@@...@....@..@..@.@@.@..@@.@..@.@........@.@@..@............@@.@@@...........@.@@..@............@@.@@@...@....@..@..@.@
.@..@@@...........@..............@...@..........@@@@......@..@...@..@@@...........@..............@...@..@@@...........@..............@...@..........@@
.@....@...@.....@@.....@....@...@....@.........@..@@@.....@@...@.@....@...@.....@@.....@....@...@....@....@...@.....@@.....@....@...@....@.........@..
.......@...........@...@...........@@..................................@...........@...@...........@.......@...........@...@...........@@.............
.......@@....@....@..@..@..@@.....@.@.......@......@..@@@@....@........@@....@....@..@..@..@@.....@........@@....@....@..@..@..@@.....@.@.......@.....
.......@.........@.@..@.@........@............@........@...@...........@.........@.@..@.@........@.........@.........@.@..@.@........@............@...
...@.............@.............@....@.@......@...@.............@...@.............@.............@.......@.............@.............@....@.@......@...@
..............@@..@@......@..@..................@....@..@....@................@@..@@......@..@....................@@..@@......@..@..................@.
@.@....@..@..@.@..@.@@.....................@@...............@@..@.@....@..@..@.@..@.@@..............@.@....@..@..@.@..@.@@.....................@@.....
.@.......@..........@.@@........@..@@.....@@@......@.....@.......@.......@..........@.@@........@..@.@.......@..........@.@@........@..@@.....@@@.....
...@..@...@..@...@..@.....@..............@.@.@....@..@....@........@..@...@..@...@..@.....@............@..@...@..@...@..@.....@..............@.@.@....
........@@............@.....@........@@.................................@@............@.....@...............@@............@.....@........@@...........
..@....@..............@...................@.....@.....@@..........@....@..............@...............@....@..............@...................@.....@.
....@.@.......@..@.@...........@.......................@.....@@.....@.@.......@..@.@...........@........@.@.......@..@.@...........@..................
.@.....@@...........@@.@.@.@.@.@@...@..@.@.......@@.........@....@.....@@...........@@.@.@.@.@.@@....@.....@@...........@@.@.@.@.@.@@...@..@.@.......@
...@...@.@@....@.........@@...@.....@...................@..@@......@...@.@@....@.........@@...@........@...@.@@....@.........@@...@.....@.............
@.@@.@....@.......@.............@..@....@...............@.......@.@@.@....@.......@.............@..@@.@@.@....@.......@.............@..@....@.........
.....@................@@....@.@.......@@........@..@....@.....@......@................@@....@.@..........@................@@....@.@.......@@........@.
..@@......@.@.@.....@...@@..@.@.....@......................@...@..@@......@.@.@.....@...@@..@.@.......@@......@.@.@.....@...@@..@.@.....@.............
@@....@...@................@.............@.......@...@...@..@..@@@....@...@................@........@@....@...@................@.............@.......@
...................@.@.........@@.....@.....@.....@....@.....@.....................@.@.........@@......................@.@.........@@.....@.....@.....
@.@@....@.@..@.@..@..@..........@......@.@..@..@...@..@.........@.@@....@.@..@.@..@..@..........@...@.@@....@.@..@.@..@..@..........@......@.@..@..@..
@.....@................@.@.@.....@@.@...@..@.....@..@...........@.....@................@.@.@.....@@.@.....@................@.@.@.....@@.@...@..@.....@
.............@..@@...@..@...@@@@.....@..@.......@...@....@@....@.............@..@@...@..@...@@@@.................@..@@...@..@...@@@@.....@..@.......@.
@.@.......@...@..@...........@..@.........@....@..@..@.@........@.@.......@...@..@...........@..@...@.@.......@...@..@...........@..@.........@....@..
@@@@..@..@...............@......@..........@...@...@.@..@..@@..@@@@@..@..@...............@......@...@@@@..@..@...............@......@..........@...@..
@@....@...............@.....@..@..@@......@@...............@@...@@....@...............@.....@..@..@@@@....@...............@.....@..@..@@......@@......
@......@.@@.@..@@.@@@...@.......@......@.........@....@....@....@......@.@@.@..@@.@@@...@.......@...@......@.@@.@..@@.@@@...@.......@......@.........@
.........@@@........@@...........@.....@....@.@.@....@.@...@.............@@@........@@...........@...........@@@........@@...........@.....@....@.@...
................@.@..@@.....@...@.@.@..@........@...@..........@................@.@..@@.....@...@.@.................@.@..@@.....@...@.@.@..@........@.
...@..@..@.........@@.....@....@.........@..@...@@@...........@@...@..@..@.........@@.....@....@.......@..@..@.........@@.....@....@.........@..@...@@
..@.....@...@............@..@......@....@......@.....@@@....@.@@..@.....@...@............@..@......@..@.....@...@............@..@......@....@......@..
........@.....@@....@.....@.@.....@.....@.@..@..............@..@........@.....@@....@.....@.@.....@@........@.....@@....@.....@.@.....@.....@.@..@....
...@.........@....@................@.@@...........@.....@...@......@.........@....@................@...@.........@....@................@.@@...........
..@@@......@@..........@@.................@..@...@@..@.......@....@@@......@@..........@@.............@@@......@@..........@@.................@..@...@
@..@........@..@.@...@....@.......@......@...@...........@......@..@........@..@.@...@....@.......@.@..@........@..@.@...@....@.......@......@...@....
.....@.@.......@.@@......@.....@..@...@......@@@.....@.......@@......@.@.......@.@@......@.....@..@......@.@.......@.@@......@.....@..@...@......@@@..
..@....@...@@....@.@.@@@........@...@.@.......@.....@.....@.......@....@...@@....@.@.@@@........@.....@....@...@@....@.@.@@@........@...@.@.......@...
.............@@.....@@...@.......@@.@....@.@.....@@.@@.......@...............@@.....@@...@.......@@..............@@.....@@...@.......@@.@....@.@.....@
