type octile
height 31
width 22
map
......................
......TTTTTTTTTT......
......TTTTTTTTTT......
......................
......TTTTTTTTTT......
......TTTTTTTTTT......
......................
......TTTTTTTTTT......
......TTTTTTTTTT......
......................
......TTTTTTTTTT......
......TTTTTTTTTT......
......................
......TTTTTTTTTT......
......TTTTTTTTTT......
......................
......TTTTTTTTTT......
......TTTTTTTTTT......
......................
......TTTTTTTTTT......
......TTTTTTTTTT......
......................
......TTTTTTTTTT......
......TTTTTTTTTT......
......................
......TTTTTTTTTT......
......TTTTTTTTTT......
......................
......TTTTTTTTTT......
......TTTTTTTTTT......
......................
