type octile
height 60
width 60
map
......@..@...@@@.@..@....@..@....@...............@..........
..@.....@@..@.................@.........@...@...@.@.@.@.....
...@.@........@..........@@..@.....@@......@...@...@........
...............@@....@.@...@............@...@.....@.....@@@.
..@....@..@................@.......@@@......@........@......
.....@@..@.@....@.............@.@...@......@.....@@.@.......
..@......@....@..@.@.@...@@...@....@...........@@@..@..@..@.
...@@@.@.....@.@....@...@@...@...............@.@....@....@..
@@.@...@.....@.....@.....@.............@@@..@...@......@....
..........@...@@........@...@...@....@.........@.........@..
....@.......@..@..............@.........................@...
........@.@@..@............@@.@@@...@....@..@..@.@@.@..@@.@.
.@..@@@...........@..............@...@..........@@@@......@.
.@....@...@.....@@.....@....@...@....@.........@..@@@.....@@
.......@...........@...@...........@@.......................
.......@@....@....@..@..@..@@.....@.@.......@......@..@@@@..
.......@.........@.@..@.@........@............@........@...@
...@.............@.............@....@.@......@...@..........
..............@@..@@......@..@..................@....@..@...
@.@....@..@..@.@..@.@@.....................@@...............
.@.......@..........@.@@........@..@@.....@@@......@.....@..
...@..@...@..@...@..@.....@..............@.@.@....@..@....@.
........@@............@.....@........@@.....................
..@....@..............@...................@.....@.....@@....
....@.@.......@..@.@...........@.......................@....
.@.....@@...........@@.@.@.@.@.@@...@..@.@.......@@.........
...@...@.@@....@.........@@...@.....@...................@..@
@.@@.@....@.......@.............@..@....@...............@...
.....@................@@....@.@.......@@........@..@....@...
..@@......@.@.@.....@...@@..@.@.....@......................@
@@....@...@................@.............@.......@...@...@..
...................@.@.........@@.....@.....@.....@....@....
@.@@....@.@..@.@..@..@..........@......@.@..@..@...@..@.....
@.....@................@.@.@.....@@.@...@..@.....@..@.......
.............@..@@...@..@...@@@@.....@..@.......@...@....@@.
@.@.......@...@..@...........@..@.........@....@..@..@.@....
@@@@..@..@...............@......@..........@...@...@.@..@..@
@@....@...............@.....@..@..@@......@@...............@
@......@.@@.@..@@.@@@...@.......@......@.........@....@....@
.........@@@........@@...........@.....@....@.@.@....@.@...@
................@.@..@@.....@...@.@.@..@........@...@.......
...@..@..@.........@@.....@....@.........@..@...@@@.........
..@.....@...@............@..@......@....@......@.....@@@....
........@.....@@....@.....@.@.....@.....@.@..@..............
...@.........@....@................@.@@...........@.....@...
..@@@......@@..........@@.................@..@...@@..@......
@..@........@..@.@...@....@.......@......@...@...........@..
.....@.@.......@.@@......@.....@..@...@......@@@.....@......
..@....@...@@....@.@.@@@........@...@.@.......@.....@.....@.
.............@@.....@@...@.......@@.@....@.@.....@@.@@......
..@.......@......@......@...........@@.@..........@.@@..@..@
.....@....@@..@...@...@.......@......@....@..@@....@...@.@..
..@.......@..@.............@.@@......@@.@...@.........@.....
@@...@....@.@..@.@..@..@..@.@.@...@@@...@.@......@..@....@..
.....@.......@.......@..@..........@@@............@.....@.@.
...@....@......@.@...@..@..@.....@@@@@...@.....@..@.@..@...@
.....@.....@...@...@@...@...@@..@...@..............@...@...@
.......@....@.@@...@@.@@........@....@.@.@@@..@....@....@@..
......@....@@....@@.@.@....@.@.@..@.@......@...@.....@@.....
.......@@..@...........@....@....@......@..@..@...@.@@@@@...
